State.Area,Year,sTotalEmployment,sTotalUnemployment,sTotalCivNonIns,sTotalCivLabor
Alabama,1976,16797385,1205731,31592000,18003116
Alabama,1977,17431846,1340714,32267000,18772560
Alabama,1978,18207821,1246188,32941000,19454009
Alabama,1979,18494203,1440984,33487000,19935187
Alabama,1980,18378547,1777370,33951000,20155917
Alabama,1981,18073034,2164522,34371000,20237556
Alabama,1982,17754972,2881944,34675000,20636916
Alabama,1983,18163240,2915605,34933000,21078845
Alabama,1984,19016116,2419684,35268000,21435800
Alabama,1985,19590922,2067269,35629000,21658191
Alabama,1986,20102366,2127025,36013000,22229391
Alabama,1987,20577853,1833890,36430000,22411743
Alabama,1988,20856099,1639133,36690000,22495232
Alabama,1989,21193758,1596563,36874000,22790321
Alabama,1990,21360356,1565491,36868742,22925847
Alabama,1991,21402531,1689864,37380063,23092395
Alabama,1992,21773139,1773811,37816563,23546950
Alabama,1993,22231184,1731304,38331063,23962488
Alabama,1994,22889528,1505826,38746563,24395354
Alabama,1995,23342923,1447992,39046063,24790915
Alabama,1996,23793320,1306112,39415563,25099432
Alabama,1997,24329108,1261126,39728063,25590234
Alabama,1998,24564436,1147835,40104563,25712271
Alabama,1999,24584301,1217217,40340063,25801518
Alabama,2000,24574766,1194033,40540721,25768799
Alabama,2001,24200085,1323225,40707759,25523310
Alabama,2002,23858845,1499659,40853405,25358504
Alabama,2003,24012153,1527285,41057629,25539438
Alabama,2004,24224567,1433605,41329022,25658172
Alabama,2005,24539247,1142148,41728688,25681395
Alabama,2006,24996398,1042794,42267274,26039192
Alabama,2007,25109405,1061017,42695486,26170422
Alabama,2008,24592286,1534123,43102698,26126409
Alabama,2009,23273602,2610592,43456920,25884194
Alabama,2010,23625081,2735252,44282961,26360333
Alabama,2011,23892319,2531135,44701016,26423454
Alabama,2012,24013411,2135488,44948311,26148899
Alabama,2013,24165174,1910135,45191108,26075309
Alabama,2014,24224848,1750298,45398295,25975146
Alabama,2015,24249161,1580814,45592477,25829975
Alabama,2016,24347148,1521869,45803433,25869017
Alabama,2017,25244885,1195671,46671260,26440556
Alabama,2018,25822118,1055694,46939860,26877812
Alabama,2019,26400151,868716,47229454,27268867
Alabama,2020,25491382,1741742,47592433,27233124
Alabama,2021,26197999,915201,47879153,27113200
Alabama,2022,26720248,712065,48164293,27432313
Alaska,1976,1821994,149355,2879000,1971349
Alaska,1977,1875764,205917,2977000,2081681
Alaska,1978,1951205,232057,3060000,2183262
Alaska,1979,2015727,200536,3098000,2216263
Alaska,1980,2051544,216692,3168000,2268236
Alaska,1981,2156360,218310,3285000,2374670
Alaska,1982,2303358,257384,3509000,2560742
Alaska,1983,2486366,279401,3838000,2765767
Alaska,1984,2630801,288280,4028000,2919081
Alaska,1985,2700735,294916,4119000,2995651
Alaska,1986,2717960,339190,4199000,3057150
Alaska,1987,2692100,303649,4146000,2995749
Alaska,1988,2747445,262888,4164000,3010333
Alaska,1989,2878563,220367,4200000,3098930
Alaska,1990,3006709,235673,4463598,3242382
Alaska,1991,3039965,276897,4579086,3316862
Alaska,1992,3131931,304064,4735844,3435995
Alaska,1993,3255183,275542,4840603,3530725
Alaska,1994,3334050,274893,4909362,3608943
Alaska,1995,3366267,266531,4987119,3632798
Alaska,1996,3428545,274572,5047878,3703117
Alaska,1997,3488115,259773,5083637,3747888
Alaska,1998,3544261,240091,5120395,3784352
Alaska,1999,3574344,244734,5192153,3819078
Alaska,2000,3595276,242319,5233349,3837595
Alaska,2001,3616811,242649,5319241,3859460
Alaska,2002,3644179,281893,5424771,3926072
Alaska,2003,3681706,306344,5519367,3988050
Alaska,2004,3748248,300560,5651987,4048808
Alaska,2005,3843462,286160,5762663,4129622
Alaska,2006,3907840,277472,5880582,4185312
Alaska,2007,3939351,263066,5951040,4202417
Alaska,2008,3987941,276441,6020273,4264382
Alaska,2009,3970298,343798,6142828,4314096
Alaska,2010,3986354,353189,6222318,4339543
Alaska,2011,4034526,338817,6342719,4373343
Alaska,2012,4054980,316337,6419847,4371317
Alaska,2013,4058505,305156,6461780,4363661
Alaska,2014,4077299,294750,6484475,4372049
Alaska,2015,4074950,272996,6512220,4347946
Alaska,2016,4058625,286543,6559069,4345168
Alaska,2017,4044968,281547,6557592,4326515
Alaska,2018,4008155,257631,6548403,4265786
Alaska,2019,4001235,237088,6538860,4238323
Alaska,2020,3817886,345873,6538147,4163759
Alaska,2021,3965907,272305,6549909,4238212
Alaska,2022,4108677,172472,6562010,4281149
Arizona,1976,10633911,1149991,19811000,11783902
Arizona,1977,11470085,1049519,20715000,12519604
Arizona,1978,12239334,774051,21709000,13013385
Arizona,1979,13154582,702845,22897000,13857427
Arizona,1980,13806505,977659,23903000,14784164
Arizona,1981,14313179,944023,24630000,15257202
Arizona,1982,14524970,1608869,25416000,16133839
Arizona,1983,15161465,1516720,26288000,16678185
Arizona,1984,16410305,854885,27226000,17265190
Arizona,1985,16752845,1136561,28232000,17889406
Arizona,1986,17501139,1327106,29127000,18828245
Arizona,1987,18090955,1258991,30132000,19349946
Arizona,1988,18675785,1279110,30865000,19954895
Arizona,1989,19465196,1074742,31418000,20539938
Arizona,1990,20291958,1117850,33325173,21409808
Arizona,1991,20433528,1272451,34253001,21705979
Arizona,1992,20798836,1703491,35451867,22502327
Arizona,1993,21818455,1479966,36843733,23298421
Arizona,1994,23693823,1560797,38572598,25254620
Arizona,1995,25420378,1427242,40173465,26847620
Arizona,1996,25935091,1506797,41580330,27441888
Arizona,1997,26384032,1282870,43011196,27666902
Arizona,1998,27453551,1225073,44166062,28678624
Arizona,1999,28459717,1331335,45210927,29791052
Arizona,2000,28934271,1200012,46190466,30134283
Arizona,2001,29641574,1471426,47438328,31113000
Arizona,2002,30219368,1982926,48775241,32202294
Arizona,2003,30850537,1895646,50091840,32746183
Arizona,2004,31789236,1664458,51648429,33453694
Arizona,2005,32751725,1598734,53585409,34350459
Arizona,2006,34111534,1532546,55560008,35644080
Arizona,2007,34871697,1358194,57125399,36229891
Arizona,2008,34992017,2157322,58419919,37149339
Arizona,2009,33928768,3631114,59417236,37559882
Arizona,2010,33331003,3823435,58761844,37154438
Arizona,2011,33164164,3456987,59115903,36621151
Arizona,2012,33598977,3058611,60079650,36657588
Arizona,2013,33911286,2868595,61030410,36779881
Arizona,2014,34873632,2547354,62136093,37420986
Arizona,2015,35896092,2324948,63313744,38221040
Arizona,2016,36907297,2140147,64613298,39047444
Arizona,2017,36951033,1927027,64103603,38878060
Arizona,2018,37989206,1919822,65213957,39909028
Arizona,2019,39192738,1982002,66453468,41174740
Arizona,2020,38384811,3258172,67864030,41642983
Arizona,2021,40230666,2146641,69069528,42377307
Arizona,2022,41709574,1656705,70317266,43366279
Arkansas,1976,9986054,739304,18559000,10725358
Arkansas,1977,10377502,718775,18983000,11096277
Arkansas,1978,10674077,708529,19395000,11382606
Arkansas,1979,10975067,735317,19763000,11710384
Arkansas,1980,11014207,897881,20042000,11912088
Arkansas,1981,11198644,1054476,20239000,12253120
Arkansas,1982,11096315,1159961,20376000,12256276
Arkansas,1983,11243137,1207966,20601000,12451103
Arkansas,1984,11505910,1073901,20805000,12579811
Arkansas,1985,11582550,1073757,20971000,12656307
Arkansas,1986,11771108,1099785,21140000,12870893
Arkansas,1987,12044333,1067780,21328000,13112113
Arkansas,1988,12276551,1023548,21420000,13300099
Arkansas,1989,12530993,949705,21491000,13480698
Arkansas,1990,12632932,930334,21367350,13563266
Arkansas,1991,12641172,997649,21637414,13638821
Arkansas,1992,12935871,972993,21899709,13908864
Arkansas,1993,13228477,863458,22292004,14091935
Arkansas,1994,13691918,787059,22630300,14478977
Arkansas,1995,13957846,713031,22950595,14670877
Arkansas,1996,14081449,767123,23265890,14848572
Arkansas,1997,14115138,761623,23559185,14876761
Arkansas,1998,14188676,753667,23780481,14942343
Arkansas,1999,14399993,683231,24050776,15083224
Arkansas,2000,14496482,633063,24312523,15129545
Arkansas,2001,14413236,720258,24477282,15133494
Arkansas,2002,14509961,815381,24636943,15325342
Arkansas,2003,14500380,888176,24822834,15388556
Arkansas,2004,14753784,871743,25051043,15625527
Arkansas,2005,15166657,841185,25354177,16007842
Arkansas,2006,15308730,849055,25715068,16157785
Arkansas,2007,15336456,872957,25994626,16209413
Arkansas,2008,15407619,887709,26235642,16295328
Arkansas,2009,14985076,1254247,26442789,16239323
Arkansas,2010,14967810,1278138,26792786,16245948
Arkansas,2011,15003427,1287070,27053077,16290497
Arkansas,2012,15026081,1177239,27203879,16203320
Arkansas,2013,14855827,1125479,27322580,15981306
Arkansas,2014,14995750,938965,27446338,15934715
Arkansas,2015,15276584,796315,27588889,16072899
Arkansas,2016,15485095,643276,27744819,16128371
Arkansas,2017,15572896,603243,27750544,16176139
Arkansas,2018,15536565,589842,27855414,16126407
Arkansas,2019,15686988,568419,27969004,16255407
Arkansas,2020,15163215,1000761,28150566,16163976
Arkansas,2021,15426359,652878,28342192,16079237
Arkansas,2022,15887086,544195,28554412,16431281
California,1976,107919395,10867887,189885000,118787282
California,1977,114090205,10432320,195335000,124522525
California,1978,121626786,9338420,201140000,130965206
California,1979,127006975,8432259,206570000,135439234
California,1980,129673488,9616660,212248000,139290148
California,1981,131268332,10529058,216822000,141797390
California,1982,131187473,14680973,221119000,145868446
California,1983,133118491,14505664,224700000,147624155
California,1984,139631995,11733912,229946000,151365907
California,1985,144429054,11189380,235729000,155618434
California,1986,149245343,10817513,240782000,160062856
California,1987,155292856,9616952,246302000,164909808
California,1988,160698502,8948379,251797000,169646881
California,1989,165583852,8883915,257508000,174467767
California,1990,171163595,10499372,271179048,181662967
California,1991,167405221,14194414,273370320,181599635
California,1992,166450577,17170125,276582499,183620702
California,1993,165722211,17473791,277790680,183196002
California,1994,167301666,15847442,278335861,183149108
California,1995,168823638,14448117,279232040,183271755
California,1996,171237108,13566203,281438220,184803311
California,1997,177562038,12126210,285955402,189688248
California,1998,182593658,11521137,291259581,194114795
California,1999,186960821,10402826,296528761,197363647
California,2000,192147178,9918775,301394713,202065953
California,2001,193895855,11218634,306316415,205114489
California,2002,192990372,13977181,310588871,206967553
California,2003,192965079,14296492,314526847,207261571
California,2004,195477313,12958654,318039838,208435967
California,2005,199132934,11318814,321141003,210451748
California,2006,201549095,10391931,324152056,211941026
California,2007,203491527,11437805,327294657,214929332
California,2008,202240770,15950012,331276491,218190782
California,2009,194390473,25338520,335360772,219728993
California,2010,192961252,27445164,342387796,220406416
California,2011,194619827,26242318,347434137,220862145
California,2012,198522887,23344478,351547627,221867365
California,2013,202704400,20117395,355521531,222821795
California,2014,207177901,16947313,359555235,224125214
California,2015,211794745,14103517,363404080,225898262
California,2016,215581091,12585787,366826067,228166878
California,2017,219067498,11135681,369655465,230203179
California,2018,221607107,9855374,371558143,231462481
California,2019,223443620,9537168,372682483,232980788
California,2020,204501879,23091457,374211998,227593336
California,2021,211055798,16669519,373084409,227725317
California,2022,221255470,9648188,373125022,230903658
Colorado,1976,14003434,882145,22299000,14885579
Colorado,1977,14546212,986281,23084000,15532493
Colorado,1978,15357825,900003,23937000,16257828
Colorado,1979,16428579,796722,24838000,17225301
Colorado,1980,16921221,1058321,25534000,17979542
Colorado,1981,17456295,1045709,26262000,18502004
Colorado,1982,17682496,1458905,27063000,19141401
Colorado,1983,18503365,1414106,27779000,19917471
Colorado,1984,19332179,1124166,28259000,20456345
Colorado,1985,19304116,1228641,28632000,20532757
Colorado,1986,18922336,1535920,28988000,20458256
Colorado,1987,18896593,1540821,29241000,20437414
Colorado,1988,19159201,1313844,29358000,20473045
Colorado,1989,19384889,1147007,29525000,20531896
Colorado,1990,20157923,1091266,29865089,21249189
Colorado,1991,20499735,1144306,30511008,21644041
Colorado,1992,20817145,1354009,31437768,22171154
Colorado,1993,21905370,1244844,32560528,23150214
Colorado,1994,23415553,1014940,33673288,24430493
Colorado,1995,24483649,1023658,34694048,25507307
Colorado,1996,24820721,1078089,35634808,25898810
Colorado,1997,25688056,891049,36515568,26579105
Colorado,1998,26662407,998983,37339328,27661390
Colorado,1999,27206013,847202,38299089,28053215
Colorado,2000,27527718,773049,39176069,28300767
Colorado,2001,27650821,1098653,40145969,28749474
Colorado,2002,27721375,1673137,40871562,29394512
Colorado,2003,28057731,1824539,41421848,29882270
Colorado,2004,28765431,1696592,41892714,30462023
Colorado,2005,29306083,1563753,42577439,30869836
Colorado,2006,30336131,1350228,43459583,31686359
Colorado,2007,31068140,1193692,44317776,32261832
Colorado,2008,31215030,1602636,45207366,32817666
Colorado,2009,30193935,2580426,46060030,32774361
Colorado,2010,29608685,2972458,46436494,32581143
Colorado,2011,29916013,2846065,47103524,32762078
Colorado,2012,30366486,2635546,47923745,33002032
Colorado,2013,30961501,2237786,48779867,33199287
Colorado,2014,31931995,1671539,49708719,33603534
Colorado,2015,32646762,1264481,50805314,33911243
Colorado,2016,33638600,1088902,51870810,34727502
Colorado,2017,34625967,930981,52523346,35556948
Colorado,2018,35535168,1114990,53419707,36650158
Colorado,2019,36276240,995359,54236582,37271599
Colorado,2020,34550311,2501974,55058884,37052285
Colorado,2021,35838759,2067936,55625459,37906695
Colorado,2022,37240817,1158823,56167353,38399640
Connecticut,1976,15847350,1599471,27121000,17446821
Connecticut,1977,16568454,1245071,27432000,17813525
Connecticut,1978,17197502,962608,27754000,18160110
Connecticut,1979,17811240,954537,28070000,18765777
Connecticut,1980,17944312,1080238,28418000,19024550
Connecticut,1981,18009821,1189240,28761000,19199061
Connecticut,1982,18008049,1325069,28999000,19333118
Connecticut,1983,18274791,1166720,29184000,19441511
Connecticut,1984,19104718,934234,29413000,20038952
Connecticut,1985,19530799,896350,29639000,20427149
Connecticut,1986,20026276,782432,29850000,20808708
Connecticut,1987,20311110,659401,30066000,20970511
Connecticut,1988,20359377,603403,30202000,20962780
Connecticut,1989,20463969,765756,30186000,21229725
Connecticut,1990,20720213,1078928,30882044,21799141
Connecticut,1991,20505544,1438567,30848803,21944111
Connecticut,1992,20224520,1597182,30703485,21821702
Connecticut,1993,20142779,1398163,30627168,21540942
Connecticut,1994,19927280,1170934,30583851,21098214
Connecticut,1995,19779168,1106480,30609534,20885648
Connecticut,1996,19899232,1091930,30706218,20991162
Connecticut,1997,20076300,984515,30799901,21060815
Connecticut,1998,20208714,676917,30878583,20885631
Connecticut,1999,20420415,514425,30993266,20934840
Connecticut,2000,20678113,446212,31137686,21124325
Connecticut,2001,20384681,605756,31338926,20990437
Connecticut,2002,20376437,938662,31584757,21315099
Connecticut,2003,20259238,1168938,31817659,21428176
Connecticut,2004,20237953,1083989,31975727,21321942
Connecticut,2005,20499827,1034655,32127194,21534482
Connecticut,2006,20998251,970975,32328460,21969226
Connecticut,2007,21281191,993574,32494744,22274765
Connecticut,2008,21265905,1272750,32727383,22538655
Connecticut,2009,20779391,1884309,32961998,22663700
Connecticut,2010,20740811,2193942,33578415,22934753
Connecticut,2011,20901427,2070056,33949073,22971483
Connecticut,2012,20760214,1896104,34145307,22656318
Connecticut,2013,20636536,1781264,34282910,22417800
Connecticut,2014,21168247,1500894,34408314,22669141
Connecticut,2015,21430673,1274128,34466660,22704801
Connecticut,2016,21615110,1106136,34497959,22721246
Connecticut,2017,22060786,1018648,34816506,23079434
Connecticut,2018,22186302,895752,34919456,23082054
Connecticut,2019,22428740,837877,34959219,23266617
Connecticut,2020,20806363,1796532,34974671,22602895
Connecticut,2021,20869311,1396430,35240562,22265741
Connecticut,2022,22231526,963880,35365555,23195406
Delaware,1976,2888578,271209,5048000,3159787
Delaware,1977,2997948,266950,5143000,3264898
Delaware,1978,3093490,235385,5217000,3328875
Delaware,1979,3143896,235966,5270000,3379862
Delaware,1980,3154987,256266,5282000,3411253
Delaware,1981,3187614,268724,5341000,3456338
Delaware,1982,3232375,295015,5409000,3527390
Delaware,1983,3274497,280618,5472000,3555115
Delaware,1984,3465226,229605,5555000,3694831
Delaware,1985,3604121,195600,5659000,3799721
Delaware,1986,3731096,162782,5761000,3893878
Delaware,1987,3877283,121390,5884000,3998673
Delaware,1988,4044984,124863,6006000,4169847
Delaware,1989,4152532,142021,6114000,4294553
Delaware,1990,4130664,190760,6145144,4321424
Delaware,1991,4087314,257102,6251886,4344416
Delaware,1992,4173187,230482,6343840,4403669
Delaware,1993,4289478,221475,6446795,4510953
Delaware,1994,4393372,216577,6540748,4609949
Delaware,1995,4434439,197740,6666702,4632179
Delaware,1996,4434822,231234,6781655,4666056
Delaware,1997,4490799,187328,6881608,4678127
Delaware,1998,4586575,166802,6978564,4753377
Delaware,1999,4644434,157411,7074517,4801845
Delaware,2000,4778628,178065,7164978,4956693
Delaware,2001,4876375,180162,7257686,5056537
Delaware,2002,4793297,213554,7358124,5006851
Delaware,2003,4767949,222442,7468304,4990391
Delaware,2004,4834895,217137,7592644,5052032
Delaware,2005,4966359,233398,7739789,5199757
Delaware,2006,5111006,208017,7890444,5319023
Delaware,2007,5151543,192884,8017216,5344427
Delaware,2008,5131395,272101,8137842,5403496
Delaware,2009,4822091,439062,8233136,5261153
Delaware,2010,4782205,452938,8410770,5235143
Delaware,2011,4920601,404812,8536556,5325413
Delaware,2012,4974256,378209,8630366,5352465
Delaware,2013,4972534,351762,8732126,5324296
Delaware,2014,5127993,303908,8844800,5431901
Delaware,2015,5288351,265772,8952513,5554123
Delaware,2016,5372704,254927,9052020,5627631
Delaware,2017,5447235,254966,9168304,5702201
Delaware,2018,5549219,214387,9275190,5763606
Delaware,2019,5605708,209592,9393229,5815300
Delaware,2020,5398454,439221,9546611,5837675
Delaware,2021,5602624,326344,9701742,5928968
Delaware,2022,5691896,267719,9856601,5959615
District of Columbia,1976,3640559,343148,6207000,3983707
District of Columbia,1977,3595246,339680,6150000,3934926
District of Columbia,1978,3676666,310823,6105000,3987489
District of Columbia,1979,3680761,270981,6022000,3951742
District of Columbia,1980,3592691,287993,5900000,3880684
District of Columbia,1981,3402919,323083,5857000,3726002
District of Columbia,1982,3332402,384302,5815000,3716704
District of Columbia,1983,3367891,412195,5797000,3780086
District of Columbia,1984,3503859,340672,5796000,3844531
District of Columbia,1985,3561519,308470,5801000,3869989
District of Columbia,1986,3591338,285853,5751000,3877191
District of Columbia,1987,3696014,246320,5687000,3942334
District of Columbia,1988,3746130,198312,5591000,3944442
District of Columbia,1989,3621770,182873,5443000,3804643
District of Columbia,1990,3741064,234705,5825354,3975769
District of Columbia,1991,3546930,295607,5760164,3842537
District of Columbia,1992,3478681,325993,5684812,3804674
District of Columbia,1993,3453528,316616,5650458,3770144
District of Columbia,1994,3420920,295103,5574105,3716023
District of Columbia,1995,3292321,310028,5486754,3602349
District of Columbia,1996,3193362,293869,5439400,3487231
District of Columbia,1997,3169027,280656,5410046,3449683
District of Columbia,1998,3228459,292319,5433695,3520778
District of Columbia,1999,3422099,240455,5482342,3662554
District of Columbia,2000,3509154,212256,5496318,3721410
District of Columbia,2001,3492680,241468,5531108,3734148
District of Columbia,2002,3446862,258737,5540106,3705599
District of Columbia,2003,3433666,269719,5533020,3703385
District of Columbia,2004,3459004,304049,5559914,3763053
District of Columbia,2005,3551089,266689,5599351,3817778
District of Columbia,2006,3602606,243393,5641565,3845999
District of Columbia,2007,3684324,233670,5679673,3917994
District of Columbia,2008,3741399,275191,5733381,4016590
District of Columbia,2009,3650794,405860,5833254,4056654
District of Columbia,2010,3747135,414476,6035001,4161611
District of Columbia,2011,3795713,430103,6202602,4225816
District of Columbia,2012,3987941,393603,6337761,4381544
District of Columbia,2013,4111638,378978,6467720,4490616
District of Columbia,2014,4206509,351319,6574825,4557828
District of Columbia,2015,4338669,322215,6686914,4660884
District of Columbia,2016,4447387,295835,6781684,4743222
District of Columbia,2017,4431946,287404,6697773,4719350
District of Columbia,2018,4475488,269577,6739097,4745065
District of Columbia,2019,4537475,263312,6757914,4800787
District of Columbia,2020,4265697,363525,6655800,4629222
District of Columbia,2021,4228454,310272,6563043,4538726
District of Columbia,2022,4447931,215763,6596224,4663694
Florida,1976,39195716,4010554,78108000,43206270
Florida,1977,41011215,3698149,80642000,44709364
Florida,1978,44419720,3217483,83647000,47637203
Florida,1979,46773120,2976533,87353000,49749653
Florida,1980,48519961,3091945,91315000,51611906
Florida,1981,50706217,3703123,94867000,54409340
Florida,1982,51606883,4796529,97880000,56403412
Florida,1983,53732028,5065171,100777000,58797199
Florida,1984,57776449,4078008,103857000,61854457
Florida,1985,60182375,3890751,106931000,64073126
Florida,1986,63040059,3908434,109991000,66948493
Florida,1987,66526092,3800981,113112000,70327073
Florida,1988,69109317,3790721,115927000,72900038
Florida,1989,70919635,4208636,118690000,75128271
Florida,1990,72903326,4852223,123132345,77755549
Florida,1991,72183795,5974863,125827858,78158658
Florida,1992,72854466,6660336,128278010,79514802
Florida,1993,75164027,6002560,130638161,81166587
Florida,1994,77804924,5390645,133288313,83195569
Florida,1995,79755955,4736732,136020465,84492687
Florida,1996,81614683,4543874,138889615,86158557
Florida,1997,84275193,4365176,141858768,88640369
Florida,1998,86581993,4024742,144681919,90606735
Florida,1999,88814203,3639341,147379070,92453544
Florida,2000,91446479,3569073,149871357,95015552
Florida,2001,92299940,4268103,152765328,96568043
Florida,2002,91836375,4781287,155930427,96617662
Florida,2003,93123940,4349848,158965758,97473788
Florida,2004,96377930,3759065,162706353,100136995
Florida,2005,100811342,2961471,166736211,103772813
Florida,2006,104475036,2644032,169964676,107119068
Florida,2007,105778015,3593517,172070758,109371532
Florida,2008,103610446,6257416,173728424,109867862
Florida,2009,97565423,10321532,175073307,107886955
Florida,2010,97874975,11879696,179283124,109754671
Florida,2011,99999826,11126283,182515951,111126109
Florida,2012,102357289,9693725,185256010,112051014
Florida,2013,104507671,8500335,188071702,113008006
Florida,2014,107172746,7380484,191366562,114553230
Florida,2015,109301434,6387919,195196144,115689353
Florida,2016,112321688,5788454,199393543,118110142
Florida,2017,114526024,5139528,201820518,119665552
Florida,2018,116978266,4431643,204733458,121409909
Florida,2019,119434406,4010119,207287952,123444525
Florida,2020,111460727,9853261,210192806,121313988
Florida,2021,118478898,5782471,213316151,124261369
Florida,2022,125360507,3749001,217608745,129109508
Georgia,1976,25032663,2220626,42693000,27253289
Georgia,1977,26011099,1937262,43756000,27948361
Georgia,1978,27260882,1649679,44786000,28910561
Georgia,1979,28091334,1517730,45944000,29609064
Georgia,1980,28492449,1919245,47044000,30411694
Georgia,1981,29105698,2006126,48121000,31111824
Georgia,1982,29380879,2481600,49016000,31862479
Georgia,1983,29893386,2470270,49798000,32363656
Georgia,1984,31271114,2030609,50893000,33301723
Georgia,1985,32305166,2185955,52315000,34491121
Georgia,1986,33640392,2112106,53399000,35752498
Georgia,1987,34653707,2040436,54638000,36694143
Georgia,1988,35660740,2118356,55618000,37779096
Georgia,1989,36430380,2076344,56398000,38506724
Georgia,1990,37354166,2114943,58477734,39469109
Georgia,1991,37692392,2106626,59719413,39799018
Georgia,1992,38344179,2708589,61025980,41052768
Georgia,1993,39623910,2407237,62417545,42031147
Georgia,1994,41084914,2185775,63984112,43270689
Georgia,1995,42174389,2101287,65519677,44275676
Georgia,1996,43582409,2103560,67101244,45685969
Georgia,1997,45228326,2114176,68727809,47342502
Georgia,1998,46548893,2035331,70234376,48584224
Georgia,1999,47670398,1886887,71696941,49557285
Georgia,2000,48666884,1772934,73132908,50439818
Georgia,2001,48994546,2084938,74718793,51079484
Georgia,2002,49349957,2758194,76208595,52108151
Georgia,2003,50230470,2728481,77589341,52958951
Georgia,2004,50829881,2736773,79076371,53566654
Georgia,2005,52037552,3138655,80973599,55176207
Georgia,2006,53693038,2872936,82977582,56565974
Georgia,2007,54884468,2844246,84872026,57728714
Georgia,2008,54414764,3950713,86368908,58365477
Georgia,2009,51531509,5986773,87607065,57518282
Georgia,2010,50489265,6018463,87868259,56507728
Georgia,2011,51098421,5771231,88572438,56869652
Georgia,2012,52080989,5180685,89719713,57261674
Georgia,2013,52378222,4637924,90712825,57016146
Georgia,2014,52882706,4069065,91834345,56951771
Georgia,2015,53368230,3446929,93145334,56815159
Georgia,2016,55838547,3222338,94621117,59060885
Georgia,2017,58373427,2919511,95946523,61292938
Georgia,2018,59059610,2456778,97167130,61516388
Georgia,2019,59717489,2216147,98445726,61933636
Georgia,2020,57184420,3943514,99710886,61127934
Georgia,2021,59743438,2429833,100774536,62173271
Georgia,2022,60889545,1907054,102167115,62796599
Hawaii,1976,4464796,452122,7102000,4916918
Hawaii,1977,4616874,380715,7307000,4997589
Hawaii,1978,4707856,351593,7490000,5059449
Hawaii,1979,4856419,294592,7731000,5151011
Hawaii,1980,5024828,263211,7957000,5288039
Hawaii,1981,5125859,278852,8108000,5404711
Hawaii,1982,5160845,336216,8279000,5497061
Hawaii,1983,5314564,333753,8489000,5648317
Hawaii,1984,5381293,309360,8634000,5690653
Hawaii,1985,5476734,301829,8768000,5778563
Hawaii,1986,5642419,275754,8939000,5918173
Hawaii,1987,5911096,227220,9143000,6138316
Hawaii,1988,6030212,191448,9314000,6221660
Hawaii,1989,6202320,156805,9477000,6359125
Hawaii,1990,6434252,172049,9709761,6606301
Hawaii,1991,6589813,189585,9918118,6779398
Hawaii,1992,6635141,286653,10081004,6921794
Hawaii,1993,6682219,306477,10207892,6988696
Hawaii,1994,6634486,362175,10312778,6996661
Hawaii,1995,6638794,387804,10410665,7026598
Hawaii,1996,6715901,422101,10526552,7138002
Hawaii,1997,6791914,428927,10663440,7220841
Hawaii,1998,6810430,421145,10748326,7231575
Hawaii,1999,6869014,376369,10797214,7245383
Hawaii,2000,6957001,308229,10806643,7265230
Hawaii,2001,6975412,312094,10884606,7287506
Hawaii,2002,6933388,291894,10978164,7225282
Hawaii,2003,6961483,282741,11072832,7244224
Hawaii,2004,7098280,241946,11296018,7340226
Hawaii,2005,7295142,211703,11416397,7506845
Hawaii,2006,7430462,194398,11528226,7624860
Hawaii,2007,7433939,208313,11620374,7642252
Hawaii,2008,7386547,311090,11703857,7697637
Hawaii,2009,7081295,505520,11780287,7586815
Hawaii,2010,7249553,531201,12361943,7780754
Hawaii,2011,7383952,541628,12670134,7925580
Hawaii,2012,7344519,461719,12787732,7806238
Hawaii,2013,7442431,371298,12889792,7813729
Hawaii,2014,7631608,337742,12962938,7969350
Hawaii,2015,7772347,275156,13039702,8047503
Hawaii,2016,7915400,235444,13122662,8150844
Hawaii,2017,8157988,184000,13450779,8341988
Hawaii,2018,8107904,199315,13489939,8307219
Hawaii,2019,8027076,207633,13492248,8234709
Hawaii,2020,7030564,934477,13503077,7965041
Hawaii,2021,7556735,485113,13497719,8041848
Hawaii,2022,7833835,281739,13483999,8115574
Idaho,1976,4216905,252501,7072000,4469406
Idaho,1977,4482918,278496,7332000,4761414
Idaho,1978,4710573,274426,7580000,4984999
Idaho,1979,4844009,299911,7775000,5143920
Idaho,1980,4765824,389014,7914000,5154838
Idaho,1981,4775003,394257,8043000,5169260
Idaho,1982,4807716,527272,8157000,5334988
Idaho,1983,4952046,493844,8277000,5445890
Idaho,1984,5155086,400044,8389000,5555130
Idaho,1985,5164008,437007,8404000,5601015
Idaho,1986,5193687,474910,8485000,5668597
Idaho,1987,5233498,433037,8534000,5666535
Idaho,1988,5397946,355641,8595000,5753587
Idaho,1989,5565271,322348,8708000,5887619
Idaho,1990,5594234,333602,8743709,5927836
Idaho,1991,5728964,387614,9021029,6116578
Idaho,1992,5940737,414843,9302046,6355580
Idaho,1993,6216184,402527,9635065,6618711
Idaho,1994,6660660,386810,9965082,7047470
Idaho,1995,6827565,397624,10283101,7225189
Idaho,1996,7003828,401060,10548118,7404888
Idaho,1997,7197690,396754,10789137,7594444
Idaho,1998,7405461,408269,11000154,7813730
Idaho,1999,7456138,393782,11206173,7849920
Idaho,2000,7564015,369081,11412946,7933096
Idaho,2001,7724879,413393,11632077,8138272
Idaho,2002,7767409,462074,11859004,8229483
Idaho,2003,7836924,461641,12082050,8298565
Idaho,2004,8025222,409927,12340436,8435149
Idaho,2005,8415292,350251,12674702,8765543
Idaho,2006,8624803,306211,13034851,8931014
Idaho,2007,8787002,275088,13349010,9062090
Idaho,2008,8660781,459847,13610055,9120628
Idaho,2009,8364047,799272,13799681,9163319
Idaho,2010,8344507,801397,13985154,9145904
Idaho,2011,8419149,749654,14149109,9168803
Idaho,2012,8580139,684741,14318531,9264880
Idaho,2013,8696529,635664,14503450,9332193
Idaho,2014,8915858,408880,14717512,9324738
Idaho,2015,9169282,369486,14958694,9538768
Idaho,2016,9398886,358208,15292434,9757094
Idaho,2017,9752117,322941,15773471,10075058
Idaho,2018,10052496,297259,16156629,10349755
Idaho,2019,10357173,305677,16579735,10662850
Idaho,2020,10225900,595668,17087314,10821568
Idaho,2021,10719675,386971,17646349,11106646
Idaho,2022,11101811,304468,18079382,11406279
Illinois,1976,57740947,4032841,98130000,61773788
Illinois,1977,59517706,3937549,99369000,63455255
Illinois,1978,61182066,3892772,100385000,65074838
Illinois,1979,61903281,3650756,101044000,65554037
Illinois,1980,61032155,5451507,101685000,66483662
Illinois,1981,61369467,5786534,102345000,67156001
Illinois,1982,59699208,7685144,102690000,67384352
Illinois,1983,59336341,7872304,102945000,67208645
Illinois,1984,61191790,6143192,103363000,67334982
Illinois,1985,61756906,6149920,103631000,67906826
Illinois,1986,62639385,5689267,104178000,68328652
Illinois,1987,64032277,5156716,104891000,69188993
Illinois,1988,65346771,4715960,105483000,70062731
Illinois,1989,67565037,4354485,105989000,71919522
Illinois,1990,66675608,4482031,104297936,71157639
Illinois,1991,65997350,5190225,105224259,71187575
Illinois,1992,66621636,5697660,106131103,72319296
Illinois,1993,67485795,5466731,107146947,72952526
Illinois,1994,69093898,4258378,107871791,73352276
Illinois,1995,70222204,3851859,108487635,74074063
Illinois,1996,70955961,3963269,109215479,74919230
Illinois,1997,71944097,3616266,109936323,75560363
Illinois,1998,72689424,3393371,110769167,76082795
Illinois,1999,74147955,3424933,111581011,77572888
Illinois,2000,74469384,3465950,112162828,77935334
Illinois,2001,73229133,4208212,112898886,77437345
Illinois,2002,71119381,4989098,113585520,76108479
Illinois,2003,70617128,5104831,114191700,75721959
Illinois,2004,71461597,4706766,114715094,76168363
Illinois,2005,72536445,4392130,115337855,76928575
Illinois,2006,74589588,3593541,116107179,78183129
Illinois,2007,75642617,4041200,116919753,79683817
Illinois,2008,74651527,5190079,117741306,79841606
Illinois,2009,71171311,8073881,118524470,79245192
Illinois,2010,71003564,8306507,118861169,79310071
Illinois,2011,71124407,7696734,119398188,78821141
Illinois,2012,71867528,7151319,119915159,79018847
Illinois,2013,71566753,7132206,120331280,78698959
Illinois,2014,72575136,5609670,120590442,78184806
Illinois,2015,73460006,4695839,120630480,78155845
Illinois,2016,74066601,4636472,120578520,78703073
Illinois,2017,74839190,3892963,121700875,78732153
Illinois,2018,75247295,3450575,121617739,78697870
Illinois,2019,75471032,3119164,121510728,78590196
Illinois,2020,69081177,7092498,121504195,76173675
Illinois,2021,71778630,4654229,120991655,76432859
Illinois,2022,74137129,3534092,120430060,77671221
Indiana,1976,27506037,1765096,45750000,29271133
Indiana,1977,28105751,1719125,46421000,29824876
Indiana,1978,29293480,1723428,47147000,31016908
Indiana,1979,29555755,2035249,47733000,31591004
Indiana,1980,28450638,3061837,48157000,31512475
Indiana,1981,28390064,3056413,48420000,31446477
Indiana,1982,27580187,3756746,48573000,31336933
Indiana,1983,27634372,3450327,48669000,31084699
Indiana,1984,28904571,2670148,48920000,31574719
Indiana,1985,29935295,2486054,49107000,32421349
Indiana,1986,30651119,2236339,49440000,32887458
Indiana,1987,30957466,2022209,49901000,32979675
Indiana,1988,31766871,1730430,50290000,33497301
Indiana,1989,32604867,1615725,50596000,34220592
Indiana,1990,32000641,1716780,50184137,33717421
Indiana,1991,31706768,1915125,50908960,33621893
Indiana,1992,32228944,2088350,51476664,34317294
Indiana,1993,33590786,1808945,52108367,35399731
Indiana,1994,34927576,1708097,52629070,36635673
Indiana,1995,35806512,1663278,53174775,37469790
Indiana,1996,35727720,1474096,53736478,37201816
Indiana,1997,36147119,1276987,54125182,37424106
Indiana,1998,36333016,1125135,54470885,37458151
Indiana,1999,36365565,1104933,54829589,37470498
Indiana,2000,36371244,1143803,55206424,37515047
Indiana,2001,36123117,1595573,55561470,37718690
Indiana,2002,35983154,1964567,55886277,37947721
Indiana,2003,36126211,2007743,56252406,38133954
Indiana,2004,35921493,2055446,56586314,37976939
Indiana,2005,36360229,2068749,57034894,38428978
Indiana,2006,36891495,1934399,57555098,38825894
Indiana,2007,36662120,1775645,58036619,38437765
Indiana,2008,36633018,2315188,58493904,38948206
Indiana,2009,34577801,4024806,58888697,38602607
Indiana,2010,34266485,3839599,59553785,38106084
Indiana,2011,34852031,3409332,60032752,38261363
Indiana,2012,34946764,3130930,60390254,38077694
Indiana,2013,35441479,2870498,60773309,38311977
Indiana,2014,36448776,2301777,61126038,38750553
Indiana,2015,37324878,1878340,61407365,39203218
Indiana,2016,38237746,1747069,61776259,39984815
Indiana,2017,38596856,1399509,62277616,39996365
Indiana,2018,39326667,1393396,62690297,40720063
Indiana,2019,39494299,1346226,63110767,40840525
Indiana,2020,37216639,2929819,63599550,40146458
Indiana,2021,38708776,1567118,63976136,40275894
Indiana,2022,39634736,1222273,64292830,40857009
Iowa,1976,15409200,658235,24979000,16067435
Iowa,1977,15964596,668170,25311000,16632766
Iowa,1978,16331037,653351,25552000,16984388
Iowa,1979,16362704,714326,25705000,17077030
Iowa,1980,16126616,1016125,25815000,17142741
Iowa,1981,16020688,1119536,25921000,17140224
Iowa,1982,15560545,1426701,25903000,16987246
Iowa,1983,15611009,1397690,25911000,17008699
Iowa,1984,15860256,1197762,25923000,17058018
Iowa,1985,15824288,1262635,25789000,17086923
Iowa,1986,16144529,1172687,25674000,17317216
Iowa,1987,16553596,984181,25660000,17537777
Iowa,1988,17040316,830825,25783000,17871141
Iowa,1989,17250647,776687,25848000,18027334
Iowa,1990,16668127,775465,25061462,17443592
Iowa,1991,16826740,828361,25252838,17655101
Iowa,1992,17480958,820403,25494086,18301361
Iowa,1993,17898579,771963,25713332,18670542
Iowa,1994,18221533,680952,25908578,18902485
Iowa,1995,18393777,670309,26131824,19064086
Iowa,1996,18623292,693959,26307070,19317251
Iowa,1997,18604183,602772,26445318,19206955
Iowa,1998,18586067,543365,26563564,19129432
Iowa,1999,18615950,510643,26691810,19126593
Iowa,2000,18619246,515092,26797093,19134338
Iowa,2001,18683880,643637,26881635,19327517
Iowa,2002,18767375,778467,26958634,19545842
Iowa,2003,18436451,856246,27039581,19292697
Iowa,2004,18412532,872491,27157772,19285023
Iowa,2005,18706233,836273,27304331,19542506
Iowa,2006,19137635,731726,27494520,19869361
Iowa,2007,19209451,738815,27672204,19948266
Iowa,2008,19345018,845820,27835280,20190838
Iowa,2009,18841895,1285471,28003266,20127366
Iowa,2010,18862806,1227482,28298124,20090288
Iowa,2011,18911289,1130107,28510216,20041396
Iowa,2012,18915087,1009213,28676377,19924300
Iowa,2013,19170809,951778,28861950,20122587
Iowa,2014,19524562,863771,29040845,20388333
Iowa,2015,19651501,756076,29177754,20407577
Iowa,2016,19702927,734124,29309471,20437051
Iowa,2017,19747550,623164,29583686,20370714
Iowa,2018,20011407,529057,29697594,20540464
Iowa,2019,20360626,556680,29850524,20917306
Iowa,2020,19042727,1038764,29999134,20081491
Iowa,2021,19519198,770261,30128035,20289459
Iowa,2022,20039934,562885,30233091,20602819
Kansas,1976,12390155,534850,19771000,12925005
Kansas,1977,12799278,515289,20084000,13314567
Kansas,1978,13218619,415007,20373000,13633626
Kansas,1979,13504093,432697,20631000,13936790
Kansas,1980,13533152,624655,20871000,14157807
Kansas,1981,13566110,612002,21064000,14178112
Kansas,1982,13420296,903317,21251000,14323613
Kansas,1983,13484666,845801,21413000,14330467
Kansas,1984,13738183,720724,21544000,14458907
Kansas,1985,14003593,758089,21529000,14761682
Kansas,1986,14190020,804042,21785000,14994062
Kansas,1987,14446880,729332,21979000,15176212
Kansas,1988,14616717,686883,22148000,15303600
Kansas,1989,14717493,637706,22242000,15355199
Kansas,1990,14619967,651455,21881990,15271422
Kansas,1991,14740363,687090,22010623,15427453
Kansas,1992,15006185,717864,22292324,15724049
Kansas,1993,15154746,788824,22558025,15943570
Kansas,1994,15381137,771867,22790727,16153004
Kansas,1995,15542566,706552,23050429,16249118
Kansas,1996,15717075,697427,23280130,16414502
Kansas,1997,15943804,628380,23481831,16572184
Kansas,1998,16174129,618415,23696533,16792544
Kansas,1999,16291626,590180,23876234,16881806
Kansas,2000,16198781,636547,24016872,16835328
Kansas,2001,16063322,716820,24170919,16780142
Kansas,2002,16169632,864041,24339564,17033673
Kansas,2003,16330749,958660,24493642,17289409
Kansas,2004,16538518,966124,24625889,17504642
Kansas,2005,16613528,886783,24804132,17500311
Kansas,2006,16835091,777242,24961410,17612333
Kansas,2007,17067205,757159,25156188,17824364
Kansas,2008,17098470,826716,25333992,17925186
Kansas,2009,16902995,1252567,25543928,18155562
Kansas,2010,16755152,1250483,25784334,18005635
Kansas,2011,16825092,1148592,25941021,17973684
Kansas,2012,16867889,1023371,26091442,17891260
Kansas,2013,16931347,946618,26203371,17877965
Kansas,2014,17121725,807987,26333516,17929712
Kansas,2015,17181543,744830,26456918,17926373
Kansas,2016,17180793,720886,26567923,17901679
Kansas,2017,17212817,646970,26732758,17859787
Kansas,2018,17316646,602281,26806422,17918927
Kansas,2019,17464419,590612,26889551,18055031
Kansas,2020,16980405,1051263,27041951,18031668
Kansas,2021,17417358,595807,27133781,18013165
Kansas,2022,17576702,478797,27211072,18055499
Kentucky,1976,16947137,972418,29838000,17919555
Kentucky,1977,17563009,893819,30458000,18456828
Kentucky,1978,17974696,955505,30979000,18930201
Kentucky,1979,18284899,1072467,31436000,19357366
Kentucky,1980,18340985,1600062,31797000,19941047
Kentucky,1981,18285987,1721770,32097000,20007757
Kentucky,1982,18015743,2189349,32367000,20205092
Kentucky,1983,18071571,2293790,32643000,20365361
Kentucky,1984,18589930,1854546,32777000,20444476
Kentucky,1985,18547382,1832629,32946000,20380011
Kentucky,1986,18571192,1892321,33125000,20463513
Kentucky,1987,18738487,1690201,33295000,20428688
Kentucky,1988,19049283,1532110,33464000,20581393
Kentucky,1989,19552517,1327612,33561000,20880129
Kentucky,1990,19779476,1272665,33585011,21052141
Kentucky,1991,19576490,1547277,33933052,21123767
Kentucky,1992,19859398,1468394,34277220,21327792
Kentucky,1993,20266089,1339045,34737389,21605134
Kentucky,1994,20763715,1175400,35091557,21939115
Kentucky,1995,21080759,1201892,35476725,22282651
Kentucky,1996,21265421,1216139,35834895,22481560
Kentucky,1997,21734751,1192666,36071062,22927417
Kentucky,1998,22043081,1040557,36417231,23083638
Kentucky,1999,22320294,1048792,36746400,23369086
Kentucky,2000,22516616,974964,37033832,23491580
Kentucky,2001,22218931,1219726,37276584,23438657
Kentucky,2002,21989217,1351127,37553001,23340344
Kentucky,2003,22126922,1459297,37873729,23586219
Kentucky,2004,22340037,1300135,38112756,23640172
Kentucky,2005,22497062,1399358,38486195,23896420
Kentucky,2006,22921198,1394402,38950380,24315600
Kentucky,2007,23113773,1312369,39294466,24426142
Kentucky,2008,22869542,1596324,39694323,24465866
Kentucky,2009,22112284,2670051,39947706,24782335
Kentucky,2010,22229375,2543505,40201026,24772880
Kentucky,2011,22417754,2316714,40457910,24734468
Kentucky,2012,22694839,2028665,40674991,24723504
Kentucky,2013,22721965,1957860,40936955,24679825
Kentucky,2014,22531559,1546187,41132679,24077746
Kentucky,2015,22514326,1241074,41322402,23755400
Kentucky,2016,22973994,1217688,41518705,24191682
Kentucky,2017,23457817,1176909,41879204,24634726
Kentucky,2018,23592872,1040830,42026974,24633702
Kentucky,2019,23804292,1020510,42180731,24824802
Kentucky,2020,22631810,1569103,42354193,24200913
Kentucky,2021,23244948,1077454,42411534,24322402
Kentucky,2022,23628561,961794,42493267,24590355
Los Angeles County,1976,37172874,3592994,63841000,40765868
Los Angeles County,1977,38240506,3354675,64733000,41595181
Los Angeles County,1978,40190596,2934744,65826000,43125340
Los Angeles County,1979,41561924,2456758,66673000,44018682
Los Angeles County,1980,42391609,2963838,67680000,45355447
Los Angeles County,1981,41970875,3168150,68592000,45139025
Los Angeles County,1982,41509770,4325195,69768000,45834965
Los Angeles County,1983,41396739,4439418,71009000,45836157
Los Angeles County,1984,43061615,3625952,72321000,46687567
Los Angeles County,1985,44519868,3380371,73382300,47900239
Los Angeles County,1986,46027388,3288646,75033700,49316034
Los Angeles County,1987,47783661,2980022,76319000,50763683
Los Angeles County,1988,49258596,2655207,77259300,51913803
Los Angeles County,1989,50274446,2860126,78606200,53134572
Los Angeles County,1990,50827231,3208543,81037555,54035774
Los Angeles County,1991,49105746,4287946,80759898,53393692
Los Angeles County,1992,48094033,5248427,81092794,53342460
Los Angeles County,1993,46968264,5226552,81098090,52194816
Los Angeles County,1994,46780590,4741064,80646485,51521654
Los Angeles County,1995,47268136,4190681,80245170,51458817
Los Angeles County,1996,47715291,4229865,80320166,51945156
Los Angeles County,1997,49552591,3664296,81085962,53216887
Los Angeles County,1998,50981166,3557686,82193858,54538852
Los Angeles County,1999,51680403,3245587,83425654,54925990
Los Angeles County,2000,52964628,3026772,84689222,55991400
Los Angeles County,2001,53493686,3249888,85679960,56743574
Los Angeles County,2002,53021197,3894817,86632783,56916014
Los Angeles County,2003,52833088,3976317,87444710,56809405
Los Angeles County,2004,53263670,3676932,88021637,56940602
Los Angeles County,2005,54401076,3050472,88374927,57451548
Los Angeles County,2006,54782945,2754881,88522623,57537826
Los Angeles County,2007,55371462,2992385,88804565,58363847
Los Angeles County,2008,54634099,4465301,89505607,59099400
Los Angeles County,2009,52307126,6953966,90304643,59261092
Los Angeles County,2010,51839463,7445527,91681303,59284990
Los Angeles County,2011,52033681,7254906,92775334,59288587
Los Angeles County,2012,52392803,6476763,93689902,58869566
Los Angeles County,2013,53675361,5807954,94526539,59483315
Los Angeles County,2014,54866497,4925609,95263167,59792106
Los Angeles County,2015,55703544,3987344,95941807,59690888
Los Angeles County,2016,57011485,3218464,96455521,60229949
Los Angeles County,2017,58359879,2952807,96941317,61312686
Los Angeles County,2018,58578508,2850449,96984256,61428957
Los Angeles County,2019,59056707,2774323,96813184,61831030
Los Angeles County,2020,52183154,7316297,96448369,59499451
Los Angeles County,2021,54582762,5360716,95297545,59943478
Los Angeles County,2022,56883154,2907869,94696594,59791023
Louisiana,1976,17158063,1219734,32487000,18377797
Louisiana,1977,17891840,1334525,33305000,19226365
Louisiana,1978,18661911,1361351,34038000,20023262
Louisiana,1979,19285547,1377033,34866000,20662580
Louisiana,1980,19821773,1503537,35768000,21325310
Louisiana,1981,20284357,1867640,36544000,22151997
Louisiana,1982,20119715,2289759,37304000,22409474
Louisiana,1983,20272763,2644882,37958000,22917645
Louisiana,1984,20886141,2374522,38219000,23260663
Louisiana,1985,20938380,2704774,38391000,23643154
Louisiana,1986,20716976,2963178,38633000,23680154
Louisiana,1987,20647905,2768460,38361000,23416365
Louisiana,1988,20668584,2448159,38038000,23116743
Louisiana,1989,20871351,1781893,37868000,22653244
Louisiana,1990,21003562,1397742,36872244,22401304
Louisiana,1991,21207131,1656539,37164727,22863670
Louisiana,1992,21283095,1808978,37430794,23092073
Louisiana,1993,21207665,1709180,37720860,22916845
Louisiana,1994,21628805,1789096,37994926,23417901
Louisiana,1995,21950919,1616578,38311993,23567497
Louisiana,1996,22327238,1539749,38637059,23866987
Louisiana,1997,22673560,1418951,38928125,24092511
Louisiana,1998,23014407,1347995,39155192,24362402
Louisiana,1999,23102118,1209418,39367258,24311536
Louisiana,2000,23067077,1251849,39475731,24318926
Louisiana,2001,22955999,1360111,39557179,24316110
Louisiana,2002,22725513,1448807,39716483,24174320
Louisiana,2003,22765508,1527434,39913410,24292942
Louisiana,2004,22970570,1387905,40092075,24358475
Louisiana,2005,23160700,1774596,39484480,24935296
Louisiana,2006,23026979,989894,38376160,24016873
Louisiana,2007,23319515,997698,39466981,24317213
Louisiana,2008,23624072,1155898,40232867,24779970
Louisiana,2009,23131815,1688837,40667444,24820652
Louisiana,2010,23137483,1880712,41254447,25018195
Louisiana,2011,23107253,1853786,41733660,24961039
Louisiana,2012,23386024,1696839,42031520,25082863
Louisiana,2013,23607470,1614870,42305460,25222340
Louisiana,2014,24090716,1606044,42562188,25696760
Louisiana,2015,24186340,1622523,42816758,25808863
Louisiana,2016,23938605,1548300,43007360,25486905
Louisiana,2017,24000526,1293719,43033667,25294245
Louisiana,2018,24091282,1223119,43018848,25314401
Louisiana,2019,24096256,1167840,43018225,25264096
Louisiana,2020,22639332,2136653,43092230,24775985
Louisiana,2021,23504773,1388265,42960260,24893038
Louisiana,2022,24137028,908616,42723212,25045644
Maine,1976,5221915,494797,9274000,5716712
Maine,1977,5283866,481950,9481000,5765816
Maine,1978,5454620,374141,9664000,5828761
Maine,1979,5593129,397211,9821000,5990340
Maine,1980,5623841,453681,9913000,6077522
Maine,1981,5704691,445254,10024000,6149945
Maine,1982,5722330,537065,10118000,6259395
Maine,1983,5885605,531695,10242000,6417300
Maine,1984,6178486,402914,10383000,6581400
Maine,1985,6289919,370146,10495000,6660065
Maine,1986,6430977,359772,10601000,6790749
Maine,1987,6720222,307511,10775000,7027733
Maine,1988,6915116,263687,10977000,7178803
Maine,1989,7060704,295103,11130000,7355807
Maine,1990,7178987,407010,11273346,7585997
Maine,1991,7086923,598640,11327856,7685563
Maine,1992,7127931,564400,11344520,7692331
Maine,1993,7050047,515323,11387184,7565370
Maine,1994,7028569,494119,11421848,7522688
Maine,1995,7220438,450266,11468512,7670704
Maine,1996,7434692,417963,11554176,7852655
Maine,1997,7488154,409930,11644840,7898084
Maine,1998,7515251,350940,11710504,7866191
Maine,1999,7708887,321278,11811168,8030165
Maine,2000,7858960,270280,11930836,8129240
Maine,2001,7794584,303798,12056038,8098382
Maine,2002,7781008,363493,12190551,8144501
Maine,2003,7796907,422982,12320527,8219889
Maine,2004,7847203,382935,12427527,8230138
Maine,2005,7934109,408623,12518532,8342732
Maine,2006,8013463,396674,12609492,8410137
Maine,2007,8005171,392887,12682613,8398058
Maine,2008,7971779,453743,12748567,8425522
Maine,2009,7671285,702143,12779178,8373428
Maine,2010,7668695,704300,12876991,8372995
Maine,2011,7738618,648198,12952269,8386816
Maine,2012,7805096,604918,12988859,8410014
Maine,2013,7887111,564885,13021805,8451996
Maine,2014,7909188,467154,13071078,8376342
Maine,2015,7892297,362514,13095885,8254811
Maine,2016,8012860,314394,13136931,8327254
Maine,2017,8160982,284119,13275378,8445101
Maine,2018,8142467,267897,13350051,8410364
Maine,2019,8129890,245403,13437938,8375293
Maine,2020,7638796,410040,13541091,8048836
Maine,2021,7840156,379113,13702674,8219269
Maine,2022,7862586,238277,13830616,8100863
Maryland,1976,21458944,1505716,35729000,22964660
Maryland,1977,22195743,1441874,36363000,23637617
Maryland,1978,23216403,1377240,36923000,24593643
Maryland,1979,23845158,1458846,37374000,25304004
Maryland,1980,24018070,1698734,37745000,25716804
Maryland,1981,24163089,1842758,38335000,26005847
Maryland,1982,24017799,2159686,38718000,26177485
Maryland,1983,24649364,1837696,38976000,26487060
Maryland,1984,25538365,1439022,39458000,26977387
Maryland,1985,26075999,1264108,40075000,27340107
Maryland,1986,26929039,1282171,40703000,28211210
Maryland,1987,27646661,1245762,41400000,28892423
Maryland,1988,28266281,1235810,42134000,29502091
Maryland,1989,28960264,1143366,42682000,30103630
Maryland,1990,29552708,1336329,44288359,30889037
Maryland,1991,29526477,1867689,44630076,31394166
Maryland,1992,29778745,2080279,44919830,31859024
Maryland,1993,30028320,1911754,45199584,31940074
Maryland,1994,30586646,1680263,45539336,32266909
Maryland,1995,30937835,1622551,45873088,32560386
Maryland,1996,31356941,1627342,46311840,32984283
Maryland,1997,31662371,1595842,46670595,33258213
Maryland,1998,31753374,1407877,47033348,33161251
Maryland,1999,32097877,1147738,47455100,33245615
Maryland,2000,32431359,1186639,47932891,33617998
Maryland,2001,32606717,1426927,48595147,34033644
Maryland,2002,32825418,1648487,49280384,34473905
Maryland,2003,32906974,1656425,49883479,34563399
Maryland,2004,33020252,1594695,50481807,34614947
Maryland,2005,33604577,1574992,51046831,35179569
Maryland,2006,34312660,1497933,51529377,35810593
Maryland,2007,34543598,1333761,51907093,35877359
Maryland,2008,34692549,1648071,52286135,36340620
Maryland,2009,33839123,2763625,52768699,36602748
Maryland,2010,34050280,2891933,53859451,36942213
Maryland,2011,34446561,2716336,54638818,37162897
Maryland,2012,34882554,2573341,55213697,37455895
Maryland,2013,35104119,2449876,55671501,37553995
Maryland,2014,35348385,2149792,56047606,37498177
Maryland,2015,35803088,1878904,56370730,37681992
Maryland,2016,36247994,1625838,56581469,37873832
Maryland,2017,37372822,1555167,57588063,38927989
Maryland,2018,37751875,1494740,57884100,39246615
Maryland,2019,38656232,1353906,58154169,40010138
Maryland,2020,36361957,2521023,58466464,38882980
Maryland,2021,36067272,2018649,58613619,38085921
Maryland,2022,36816423,1234161,58645669,38050584
Massachusetts,1976,29546158,3182594,50546000,32728752
Massachusetts,1977,30459436,2596016,51050000,33055452
Massachusetts,1978,31680661,2078818,51566000,33759479
Massachusetts,1979,32395853,1880238,52064000,34276091
Massachusetts,1980,32459253,1988674,52493000,34447927
Massachusetts,1981,33076533,2261395,53010000,35337928
Massachusetts,1982,32966947,2785859,53316000,35752806
Massachusetts,1983,33273652,2477365,53667000,35751017
Massachusetts,1984,34768668,1745157,54128000,36513825
Massachusetts,1985,35135923,1511169,54406000,36647092
Massachusetts,1986,35339354,1470625,54754000,36809979
Massachusetts,1987,35988059,1253315,55049000,37241374
Massachusetts,1988,36595752,1247520,55338000,37843272
Massachusetts,1989,36628967,1615117,55415000,38244084
Massachusetts,1990,36305062,2471328,56558821,38776390
Massachusetts,1991,34845739,3383695,56347794,38229434
Massachusetts,1992,34853392,3358526,56231364,38211918
Massachusetts,1993,35461090,2790973,56323935,38252063
Massachusetts,1994,35970672,2390710,56566504,38361382
Massachusetts,1995,36337324,2098673,56965074,38435997
Massachusetts,1996,37053502,1791981,57376643,38845483
Massachusetts,1997,38060138,1608310,57837212,39668448
Massachusetts,1998,38630086,1351341,58258784,39981427
Massachusetts,1999,38987517,1328906,58732353,40316423
Massachusetts,2000,38958175,1133437,59147290,40091612
Massachusetts,2001,39096963,1540162,59670713,40637125
Massachusetts,2002,39084720,2150652,60072603,41235372
Massachusetts,2003,38677803,2349815,60343366,41027618
Massachusetts,2004,38711725,2084399,60526811,40796124
Massachusetts,2005,38679106,1947489,60764567,40626595
Massachusetts,2006,39006305,1932897,61114722,40939202
Massachusetts,2007,39341516,1860806,61614201,41202322
Massachusetts,2008,39378010,2212507,62214018,41590517
Massachusetts,2009,38294622,3368794,62848276,41663416
Massachusetts,2010,38381376,3361647,63027263,41743023
Massachusetts,2011,38790112,3019927,63546782,41810039
Massachusetts,2012,39258886,2824991,64220400,42083877
Massachusetts,2013,39409981,2800151,64892350,42210132
Massachusetts,2014,40369281,2457678,65543897,42826959
Massachusetts,2015,41019901,2062448,66059026,43082349
Massachusetts,2016,41669549,1748754,66526640,43418303
Massachusetts,2017,42985339,1704503,67850127,44689842
Massachusetts,2018,44227169,1592927,68328470,45820096
Massachusetts,2019,44704980,1392596,68704789,46097576
Massachusetts,2020,40775281,4208076,68871322,44983357
Massachusetts,2021,42436602,2486881,68945616,44923483
Massachusetts,2022,43247221,1692306,69011501,44939527
Michigan,1976,43348455,4492425,77438000,47840880
Michigan,1977,45233827,4055970,78517000,49289797
Michigan,1978,47088443,3562441,79614000,50650884
Michigan,1979,47786259,4083907,80620000,51870166
Michigan,1980,45579893,6389145,81232000,51969038
Michigan,1981,45185719,6372045,81376000,51557764
Michigan,1982,43352880,7934012,81050000,51286892
Michigan,1983,43789708,7417710,80619000,51207418
Michigan,1984,45944642,5815346,80910000,51759988
Michigan,1985,47060638,5236288,81526000,52296926
Michigan,1986,48120174,4706627,82289000,52826801
Michigan,1987,49546551,4536287,83176000,54082838
Michigan,1988,50456055,4121834,83614000,54577889
Michigan,1989,51335677,3974968,83818000,55310645
Michigan,1990,51130123,4254427,84174770,55384550
Michigan,1991,50047991,5124558,84882348,55172549
Michigan,1992,50964994,5079862,85546114,56044856
Michigan,1993,52521567,4178265,86100880,56699832
Michigan,1994,54106966,3508166,86700646,57615132
Michigan,1995,54892534,3077574,87448412,57970108
Michigan,1996,55840859,2875114,88318178,58715973
Michigan,1997,57008386,2550667,88827945,59559053
Michigan,1998,57850174,2390434,89199711,60240608
Michigan,1999,58944904,2291201,89652476,61236105
Michigan,2000,59619113,2282480,90199668,61901593
Michigan,2001,58453774,3184969,90876686,61638743
Michigan,2002,56684598,3745178,91458178,60429776
Michigan,2003,56141502,4284217,92011247,60425719
Michigan,2004,56434295,4211368,92477040,60645663
Michigan,2005,56713141,4126921,92843275,60840062
Michigan,2006,56412639,4266155,93173373,60678794
Michigan,2007,55694794,4246456,93302739,59941250
Michigan,2008,54153370,4845891,93268936,58999261
Michigan,2009,50671663,7660161,93261893,58331824
Michigan,2010,50093595,6963430,92873050,57057025
Michigan,2011,50417914,5605771,93061463,56023685
Michigan,2012,51152360,5083981,93501026,56236341
Michigan,2013,51898533,4956618,93918967,56855151
Michigan,2014,52985041,4122186,94319250,57107227
Michigan,2015,54032465,3096819,94609042,57129284
Michigan,2016,55278988,2910273,95012582,58189261
Michigan,2017,56224102,2704597,95994603,58928699
Michigan,2018,56861578,2474428,96356592,59336006
Michigan,2019,57284128,2433633,96598898,59717761
Michigan,2020,52524507,5808942,96837875,58333449
Michigan,2021,54021115,3354924,96796885,57376039
Michigan,2022,55600456,2433583,96950137,58034039
Minnesota,1976,20924220,1287020,33747000,22211240
Minnesota,1977,21825943,1215439,34340000,23041382
Minnesota,1978,22794237,928731,34890000,23722968
Minnesota,1979,23480418,1060447,35485000,24540865
Minnesota,1980,23762959,1457067,36103000,25220026
Minnesota,1981,24226150,1477155,36543000,25703305
Minnesota,1982,23880911,2053478,36837000,25934389
Minnesota,1983,24064190,2070024,37025000,26134214
Minnesota,1984,24923464,1672434,37260000,26595898
Minnesota,1985,25202741,1617728,37467000,26820469
Minnesota,1986,25538564,1510591,37948000,27049155
Minnesota,1987,26039531,1394253,38380000,27433784
Minnesota,1988,26560649,1200923,38886000,27761572
Minnesota,1989,26874965,1222733,39221000,28097698
Minnesota,1990,27404688,1350112,39246908,28754800
Minnesota,1991,27673934,1492502,39701082,29166436
Minnesota,1992,28083485,1491282,40142733,29574767
Minnesota,1993,28711301,1460446,40718380,30171747
Minnesota,1994,29723646,1244800,41290027,30968446
Minnesota,1995,30363472,1156363,41868678,31519835
Minnesota,1996,30755287,1211482,42486326,31966769
Minnesota,1997,31205859,1038642,43020973,32244501
Minnesota,1998,31729104,871768,43517622,32600872
Minnesota,1999,32076697,895791,44144272,32972488
Minnesota,2000,32572069,1018788,44766807,33590857
Minnesota,2001,32883378,1288788,45362381,34172166
Minnesota,2002,32939508,1542138,45877175,34481646
Minnesota,2003,33053238,1662452,46318993,34715690
Minnesota,2004,33113810,1590755,46720971,34704565
Minnesota,2005,33163129,1422544,47145802,34585673
Minnesota,2006,33260863,1411291,47661696,34672154
Minnesota,2007,33193375,1594675,48157138,34788050
Minnesota,2008,33069182,1904178,48602036,34973360
Minnesota,2009,32411470,2778959,49000922,35190429
Minnesota,2010,32679330,2607634,49387862,35286964
Minnesota,2011,33117393,2309449,49801799,35426842
Minnesota,2012,33406079,1999192,50213108,35405271
Minnesota,2013,33749945,1790000,50625120,35539945
Minnesota,2014,34231584,1525306,51027659,35756890
Minnesota,2015,34705769,1363967,51392707,36069736
Minnesota,2016,34883194,1401581,51823299,36284775
Minnesota,2017,35560416,1287376,52558169,36847792
Minnesota,2018,35783684,1114436,53016873,36898120
Minnesota,2019,36096810,1210381,53439080,37307191
Minnesota,2020,35233531,2360198,53845052,37593729
Minnesota,2021,35095944,1381059,54046000,36477003
Minnesota,2022,35947592,981779,54228925,36929371
Mississippi,1976,10891151,754500,19886000,11645651
Mississippi,1977,11072255,860408,20287000,11932663
Mississippi,1978,11309807,818767,20664000,12128574
Mississippi,1979,11569415,706233,20980000,12275648
Mississippi,1980,11670145,933204,21252000,12603349
Mississippi,1981,11577325,1078906,21535000,12656231
Mississippi,1982,11379283,1408713,21769000,12787996
Mississippi,1983,11317508,1537624,21909000,12855132
Mississippi,1984,11648772,1381878,22085000,13030650
Mississippi,1985,12067252,1403495,22375000,13470747
Mississippi,1986,12233666,1575684,22423000,13809350
Mississippi,1987,12424942,1389954,22526000,13814896
Mississippi,1988,12567089,1173521,22628000,13740610
Mississippi,1989,12861570,1103053,22723000,13964623
Mississippi,1990,13068348,1071773,22730950,14140121
Mississippi,1991,13015894,1194978,22981619,14210872
Mississippi,1992,13166823,1141316,23147292,14308139
Mississippi,1993,13577241,979045,23408965,14556286
Mississippi,1994,13981540,939040,23709637,14920580
Mississippi,1995,14124241,931413,24026308,15055654
Mississippi,1996,14253154,908808,24304981,15161962
Mississippi,1997,14407217,870175,24562654,15277392
Mississippi,1998,14513238,801700,24812325,15314938
Mississippi,1999,14621071,786849,25015998,15407920
Mississippi,2000,14880739,839078,25156574,15719817
Mississippi,2001,14678653,852804,25250274,15531457
Mississippi,2002,14496258,994484,25343451,15490742
Mississippi,2003,14690157,961512,25447708,15651669
Mississippi,2004,14810285,968135,25622870,15778420
Mississippi,2005,14606223,1198943,25719888,15805166
Mississippi,2006,14389082,978055,25783754,15367137
Mississippi,2007,14565353,957201,26059772,15522554
Mississippi,2008,14481803,1043144,26242871,15524947
Mississippi,2009,13801074,1423818,26396347,15224892
Mississippi,2010,14123738,1581263,26737586,15705001
Mississippi,2011,14575334,1578414,26941537,16153748
Mississippi,2012,14557426,1409365,27048135,15966791
Mississippi,2013,13985850,1297427,27169471,15283277
Mississippi,2014,13791990,1134088,27269865,14926078
Mississippi,2015,14139005,980030,27347440,15119035
Mississippi,2016,14353494,911476,27422117,15264970
Mississippi,2017,14470621,799445,27412124,15270066
Mississippi,2018,14459590,754010,27363753,15213600
Mississippi,2019,14496494,845528,27361736,15342022
Mississippi,2020,13765279,1197464,27384198,14962743
Mississippi,2021,14244186,827915,27366869,15072101
Mississippi,2022,14429807,585867,27357645,15015674
Missouri,1976,23904890,1578193,41843000,25483083
Missouri,1977,24861081,1588405,42420000,26449486
Missouri,1978,25846001,1325699,42981000,27171700
Missouri,1979,26346505,1320493,43449000,27666998
Missouri,1980,25990229,2012529,43931000,28002758
Missouri,1981,25742494,2150974,44247000,27893468
Missouri,1982,25336378,2585050,44426000,27921428
Missouri,1983,25497424,2822086,44738000,28319510
Missouri,1984,26416378,2104342,45077000,28520720
Missouri,1985,27319563,1935875,45332000,29255438
Missouri,1986,28143722,1924672,45861000,30068394
Missouri,1987,28750045,1920545,46399000,30670590
Missouri,1988,29321233,1770492,46764000,31091725
Missouri,1989,29787166,1744994,46926000,31532160
Missouri,1990,29428793,1852727,46334366,31281520
Missouri,1991,29530446,2077060,46715105,31607506
Missouri,1992,29751958,1958595,47055849,31710553
Missouri,1993,30238880,2005058,47549594,32243938
Missouri,1994,31181636,1699748,48083337,32881384
Missouri,1995,32445447,1637733,48585080,34083180
Missouri,1996,33090555,1636784,49098824,34727339
Missouri,1997,33641356,1531859,49586568,35173215
Missouri,1998,33933686,1423384,49980312,35357070
Missouri,1999,34229256,1139679,50417056,35368935
Missouri,2000,34446143,1216478,50827917,35662621
Missouri,2001,34234198,1612176,51272290,35846374
Missouri,2002,33885466,1889145,51725162,35774611
Missouri,2003,33770666,2024908,52152669,35795574
Missouri,2004,33836165,2111466,52638989,35947631
Missouri,2005,34168741,1954188,53220539,36122929
Missouri,2006,34662248,1778715,53851294,36440963
Missouri,2007,34834688,1865609,54393936,36700297
Missouri,2008,34504052,2284179,54912610,36788231
Missouri,2009,33431013,3320949,55321525,36751962
Missouri,2010,33048139,3467618,55553403,36515757
Missouri,2011,33243561,3147197,55787508,36390758
Missouri,2012,33470796,2590007,56045649,36060803
Missouri,2013,33696364,2452785,56287867,36149149
Missouri,2014,34182521,2242519,56556132,36425040
Missouri,2015,34822667,1872144,56821890,36694811
Missouri,2016,35196697,1676070,57067340,36872767
Missouri,2017,35269677,1369451,57302103,36639128
Missouri,2018,35397320,1183537,57497683,36580857
Missouri,2019,35709522,1182334,57745323,36891856
Missouri,2020,34214362,2240697,58072787,36455059
Missouri,2021,35107091,1496422,58351909,36603513
Missouri,2022,35807881,917176,58587284,36725057
Montana,1976,3782383,236034,6440000,4018417
Montana,1977,3930521,257785,6606000,4188306
Montana,1978,4124583,243136,6776000,4367719
Montana,1979,4199264,231034,6863000,4430298
Montana,1980,4184018,282192,6898000,4466210
Montana,1981,4280950,309149,6980000,4590099
Montana,1982,4257922,400625,7059000,4658547
Montana,1983,4332855,415260,7155000,4748115
Montana,1984,4473439,363371,7217000,4836810
Montana,1985,4479907,371630,7239000,4851537
Montana,1986,4464857,386320,7204000,4851177
Montana,1987,4459157,360924,7170000,4820081
Montana,1988,4527886,321302,7153000,4849188
Montana,1989,4599920,290770,7156000,4890690
Montana,1990,4545126,293493,7148030,4838619
Montana,1991,4499577,335651,7227511,4835228
Montana,1992,4690248,337137,7352655,5027385
Montana,1993,4793132,311609,7517797,5104741
Montana,1994,4949515,287446,7689940,5236961
Montana,1995,5008465,303265,7869082,5311730
Montana,1996,5080691,298683,8007226,5379374
Montana,1997,5135166,298334,8080368,5433500
Montana,1998,5238787,311700,8118511,5550487
Montana,1999,5306080,297152,8170653,5603232
Montana,2000,5369130,272103,8243229,5641233
Montana,2001,5326092,257147,8318092,5583239
Montana,2002,5340890,255173,8401152,5596063
Montana,2003,5377971,267225,8500300,5645196
Montana,2004,5479006,258778,8616681,5737784
Montana,2005,5589361,236593,8738269,5825954
Montana,2006,5744754,197879,8875345,5942633
Montana,2007,5857331,204009,9005282,6061340
Montana,2008,5855519,290568,9119962,6146087
Montana,2009,5604539,429212,9205323,6033751
Montana,2010,5578210,432078,9327062,6010288
Montana,2011,5613368,398955,9414129,6012323
Montana,2012,5726617,352888,9494301,6079505
Montana,2013,5806426,327542,9592196,6133968
Montana,2014,5867390,286745,9683771,6154135
Montana,2015,5947516,265864,9777665,6213380
Montana,2016,5991593,270015,9888502,6261608
Montana,2017,6081941,259202,10039898,6341143
Montana,2018,6181102,239603,10146830,6420705
Montana,2019,6297789,228838,10255451,6526627
Montana,2020,6160245,381454,10398558,6541699
Montana,2021,6383649,223764,10603516,6607413
Montana,2022,6634098,180093,10805769,6814191
Nebraska,1976,8331298,271310,13214000,8602608
Nebraska,1977,8581821,299205,13373000,8881026
Nebraska,1978,8759504,266509,13526000,9026013
Nebraska,1979,8840088,260009,13653000,9100097
Nebraska,1980,8819662,348851,13777000,9168513
Nebraska,1981,8888466,382415,13896000,9270881
Nebraska,1982,8870964,516025,13971000,9386989
Nebraska,1983,8925155,526679,14079000,9451834
Nebraska,1984,9064359,426218,14144000,9490577
Nebraska,1985,9169062,486708,14073000,9655770
Nebraska,1986,9291608,471027,14142000,9762635
Nebraska,1987,9344093,411553,14184000,9755646
Nebraska,1988,9459182,336975,14270000,9796157
Nebraska,1989,9508361,280808,14325000,9789169
Nebraska,1990,9657978,236149,13946239,9894127
Nebraska,1991,9798340,267415,14090114,10065755
Nebraska,1992,9890312,290147,14257214,10180459
Nebraska,1993,10080540,288308,14422316,10368848
Nebraska,1994,10339632,277372,14572417,10617004
Nebraska,1995,10535635,282932,14766517,10818567
Nebraska,1996,10678834,294966,14956619,10973800
Nebraska,1997,10764486,267793,15092720,11032279
Nebraska,1998,10840156,278025,15195820,11118181
Nebraska,1999,10860428,303359,15304920,11163787
Nebraska,2000,10952325,315475,15405265,11267800
Nebraska,2001,10985930,356577,15491500,11342507
Nebraska,2002,11016656,421018,15587690,11437674
Nebraska,2003,11144734,458313,15685759,11603047
Nebraska,2004,11227728,454050,15780388,11681778
Nebraska,2005,11229472,439144,15890135,11668616
Nebraska,2006,11302022,356132,16002994,11658154
Nebraska,2007,11405931,344767,16109233,11750698
Nebraska,2008,11463434,386702,16225962,11850136
Nebraska,2009,11306939,551791,16359275,11858730
Nebraska,2010,11343148,561034,16636681,11904182
Nebraska,2011,11510798,530526,16798967,12041324
Nebraska,2012,11682004,473318,16930814,12155322
Nebraska,2013,11734270,447950,17049935,12182220
Nebraska,2014,11755673,395138,17175878,12150811
Nebraska,2015,11777517,364107,17291931,12141624
Nebraska,2016,11818672,374092,17428575,12192764
Nebraska,2017,11912360,365254,17687126,12277614
Nebraska,2018,12073205,363792,17809442,12436997
Nebraska,2019,12225750,393834,17927940,12619584
Nebraska,2020,12037884,541976,18063607,12579860
Nebraska,2021,12256935,338065,18138653,12595000
Nebraska,2022,12409042,297471,18231679,12706513
Nevada,1976,3591727,347732,5561000,3939459
Nevada,1977,3921737,284144,5910000,4205881
Nevada,1978,4286216,197811,6345000,4484027
Nevada,1979,4590847,234607,6812000,4825454
Nevada,1980,4849618,327975,7262000,5177593
Nevada,1981,5133181,405024,7601000,5538205
Nevada,1982,5211860,582739,7892000,5794599
Nevada,1983,5276461,576079,8056000,5852540
Nevada,1984,5541874,459518,8299000,6001392
Nevada,1985,5737673,462999,8652000,6200672
Nevada,1986,5985431,406639,8841000,6392070
Nevada,1987,6263027,414067,9174000,6677094
Nevada,1988,6595863,364628,9600000,6960491
Nevada,1989,6898875,337812,10085000,7236687
Nevada,1990,7623530,376389,11273459,7999919
Nevada,1991,7906504,496426,11980486,8402930
Nevada,1992,8150010,595636,12562774,8745646
Nevada,1993,8573541,636205,13143063,9209746
Nevada,1994,9132358,607879,13904352,9740237
Nevada,1995,9614292,567216,14672639,10181508
Nevada,1996,10191905,542686,15436928,10734591
Nevada,1997,10855938,497575,16248216,11353513
Nevada,1998,11248656,489486,16967505,11738142
Nevada,1999,11796390,488597,17631793,12284987
Nevada,2000,12320751,529354,18271770,12850105
Nevada,2001,12666465,692346,18956503,13358811
Nevada,2002,12837487,772751,19617479,13610238
Nevada,2003,13076516,726940,20285035,13803456
Nevada,2004,13512772,629109,21075746,14141881
Nevada,2005,14131350,609634,21829822,14740984
Nevada,2006,14870057,628417,22600989,15498474
Nevada,2007,15391746,740789,23259462,16132535
Nevada,2008,15342784,1134278,23720043,16477062
Nevada,2009,14488996,1924975,23995484,16413971
Nevada,2010,14063700,2237257,24735511,16300957
Nevada,2011,14154494,2172993,25112089,16327487
Nevada,2012,14493863,1905575,25475448,16399438
Nevada,2013,14812182,1639097,25855648,16451279
Nevada,2014,15209057,1352044,26304990,16561101
Nevada,2015,15615367,1146547,26820338,16761914
Nevada,2016,15988516,984352,27352846,16972868
Nevada,2017,16462100,865560,27702446,17327660
Nevada,2018,17150349,785880,28294108,17936229
Nevada,2019,17793723,763142,28912268,18556865
Nevada,2020,15629782,2445320,29515644,18075102
Nevada,2021,16749700,1248970,29966223,17998670
Nevada,2022,17597212,999635,30392769,18596847
New Hampshire,1976,4480860,307656,7224000,4788516
New Hampshire,1977,4746626,278809,7508000,5025435
New Hampshire,1978,5028260,199497,7774000,5227757
New Hampshire,1979,5277414,171200,8011000,5448614
New Hampshire,1980,5357007,253334,8194000,5610341
New Hampshire,1981,5458852,290398,8366000,5749250
New Hampshire,1982,5444325,402047,8514000,5846372
New Hampshire,1983,5683320,329369,8652000,6012689
New Hampshire,1984,6004470,262523,8851000,6266993
New Hampshire,1985,6233059,237041,9088000,6470100
New Hampshire,1986,6537463,177903,9351000,6715366
New Hampshire,1987,6811464,154393,9642000,6965857
New Hampshire,1988,6954323,168893,9871000,7123216
New Hampshire,1989,7044057,244085,10049000,7288142
New Hampshire,1990,7079658,393168,10174893,7472826
New Hampshire,1991,6932442,505882,10179250,7438324
New Hampshire,1992,6875709,541338,10200035,7417047
New Hampshire,1993,6991858,454540,10288819,7446398
New Hampshire,1994,7172301,337314,10400602,7509615
New Hampshire,1995,7298652,290691,10551387,7589343
New Hampshire,1996,7349742,285932,10735171,7635674
New Hampshire,1997,7569540,263668,10897954,7833208
New Hampshire,1998,7718528,224581,11047739,7943109
New Hampshire,1999,7884814,222241,11220523,8107055
New Hampshire,2000,8012067,219083,11398126,8231150
New Hampshire,2001,8020963,281155,11585042,8302118
New Hampshire,2002,8028806,377731,11763653,8406537
New Hampshire,2003,8126565,379696,11924334,8506261
New Hampshire,2004,8258276,326989,12087572,8585265
New Hampshire,2005,8395695,316383,12233136,8712078
New Hampshire,2006,8479197,310189,12389494,8789386
New Hampshire,2007,8545801,310642,12514253,8856443
New Hampshire,2008,8580176,335603,12615840,8915779
New Hampshire,2009,8333404,544587,12687768,8877991
New Hampshire,2010,8331448,540210,12668291,8871658
New Hampshire,2011,8357862,482414,12721693,8840276
New Hampshire,2012,8407010,484465,12823844,8891475
New Hampshire,2013,8451811,467105,12905408,8918916
New Hampshire,2014,8541564,384912,13001213,8926476
New Hampshire,2015,8650758,305116,13074744,8955874
New Hampshire,2016,8770468,259129,13172642,9029597
New Hampshire,2017,8842803,255000,13351487,9097803
New Hampshire,2018,9001539,242620,13450073,9244159
New Hampshire,2019,9125302,240050,13559453,9365352
New Hampshire,2020,8556742,612257,13685359,9168999
New Hampshire,2021,8773638,308640,13800166,9082278
New Hampshire,2022,8968872,230995,13913419,9199867
New Jersey,1976,35707665,4142504,64593000,39850169
New Jersey,1977,36836997,3775434,65242000,40612431
New Jersey,1978,38532678,3009268,65975000,41541946
New Jersey,1979,39800833,2932642,66647000,42733475
New Jersey,1980,39961634,3084718,67190000,43046352
New Jersey,1981,40073312,3266823,67947000,43340135
New Jersey,1982,39843357,3802565,68571000,43645922
New Jersey,1983,40711407,3632251,69348000,44343658
New Jersey,1984,42799329,2858491,70011000,45657820
New Jersey,1985,43406562,2579215,70431000,45985777
New Jersey,1986,44431718,2351009,71373000,46782727
New Jersey,1987,45530717,1916823,72024000,47447540
New Jersey,1988,45872708,1790104,72376000,47662812
New Jersey,1989,45998748,1948547,72390000,47947295
New Jersey,1990,46237718,2471081,72546510,48708799
New Jersey,1991,45463078,3313521,72911568,48776599
New Jersey,1992,44551203,4141597,73168234,48692800
New Jersey,1993,44567798,3755137,73541900,48322935
New Jersey,1994,45478181,3329185,73898566,48807366
New Jersey,1995,46223572,3166722,74362232,49390294
New Jersey,1996,47133827,3077153,74966898,50210980
New Jersey,1997,48277255,2713815,75622563,50991070
New Jersey,1998,48506419,2322632,76229229,50829051
New Jersey,1999,49134547,2262322,76787896,51396869
New Jersey,2000,49572514,1879242,77285308,51451756
New Jersey,2001,49338288,2188064,77867027,51526352
New Jersey,2002,49138380,3008417,78431322,52146797
New Jersey,2003,49084075,3040386,78882025,52124461
New Jersey,2004,49602458,2567015,79231286,52169473
New Jersey,2005,50313838,2331562,79568024,52645400
New Jersey,2006,50772454,2464579,79897941,53237033
New Jersey,2007,51000716,2244095,80232926,53244811
New Jersey,2008,51005622,2941979,80664668,53947601
New Jersey,2009,49621520,4873154,81194121,54494674
New Jersey,2010,49425257,5287572,82331747,54712829
New Jersey,2011,49616782,5125285,82994845,54742067
New Jersey,2012,49772492,5153906,83374776,54926398
New Jersey,2013,49776131,4563481,83684399,54339612
New Jersey,2014,50294711,3629759,83937237,53924470
New Jersey,2015,50863757,3074120,84148760,53937877
New Jersey,2016,51255615,2663109,84361350,53918724
New Jersey,2017,52867732,2508793,87237015,55376525
New Jersey,2018,53042039,2214115,87742983,55256154
New Jersey,2019,54296763,1941086,88216905,56237849
New Jersey,2020,50531509,5257987,88743278,55789496
New Jersey,2021,52284477,3709314,88935410,55993791
New Jersey,2022,54785313,2090983,89051622,56876296
New Mexico,1976,5353494,511034,9696000,5864528
New Mexico,1977,5666486,473584,10063000,6140070
New Mexico,1978,5980979,395324,10397000,6376303
New Mexico,1979,6174183,440813,10747000,6614996
New Mexico,1980,6253045,515019,11059000,6768064
New Mexico,1981,6435422,500907,11331000,6936329
New Mexico,1982,6521120,647772,11616000,7168892
New Mexico,1983,6647774,714132,11909000,7361906
New Mexico,1984,6950483,581911,12137000,7532394
New Mexico,1985,7131578,669378,12332000,7800956
New Mexico,1986,7284881,740757,12670000,8025638
New Mexico,1987,7391335,723885,12875000,8115220
New Mexico,1988,7576344,622380,13005000,8198724
New Mexico,1989,7766507,561967,13146000,8328474
New Mexico,1990,7963040,570554,13420395,8533594
New Mexico,1991,8046174,630343,13669116,8676517
New Mexico,1992,8196295,647476,13973678,8843771
New Mexico,1993,8420823,660720,14303240,9081543
New Mexico,1994,8734471,610669,14692802,9345140
New Mexico,1995,8924685,637019,15051364,9561704
New Mexico,1996,9023087,731827,15375926,9754914
New Mexico,1997,9216571,634242,15594487,9850813
New Mexico,1998,9392392,624499,15802049,10016891
New Mexico,1999,9474889,563845,15967612,10038734
New Mexico,2000,9643966,511116,16104540,10155082
New Mexico,2001,9750414,508947,16239683,10259361
New Mexico,2002,9832386,570460,16472648,10402846
New Mexico,2003,9938560,622259,16708791,10560819
New Mexico,2004,10090293,593341,16959449,10683634
New Mexico,2005,10305512,564767,17241034,10870279
New Mexico,2006,10511403,462843,17540530,10974246
New Mexico,2007,10652073,396361,17793197,11048434
New Mexico,2008,10721323,483213,17991592,11204536
New Mexico,2009,10356497,786347,18195043,11142844
New Mexico,2010,10279970,866299,18721048,11146269
New Mexico,2011,10297620,802414,19001377,11100034
New Mexico,2012,10367329,777504,19118768,11144833
New Mexico,2013,10386331,769703,19211979,11156034
New Mexico,2014,10446651,737638,19260953,11184289
New Mexico,2015,10516934,743058,19329287,11259992
New Mexico,2016,10565116,766902,19413244,11332018
New Mexico,2017,10690538,689828,19525641,11380366
New Mexico,2018,10778837,559288,19615471,11338125
New Mexico,2019,10904626,569280,19747010,11473906
New Mexico,2020,10295142,883045,19946616,11178187
New Mexico,2021,10521016,800273,20050418,11321289
New Mexico,2022,10907044,457288,20117088,11364332
New York,1976,82721509,9405267,158661000,92126776
New York,1977,84265620,8502620,158929000,92768240
New York,1978,86917687,7267227,159033000,94184914
New York,1979,89138198,6814432,159347000,95952630
New York,1980,88614855,7130417,159755000,95745272
New York,1981,88833837,7273429,160687000,96107266
New York,1982,87626833,8332810,161571000,95959643
New York,1983,88111258,8588260,162569000,96699518
New York,1984,90212374,7033413,163548000,97245787
New York,1985,92980518,6582649,164192000,99563167
New York,1986,94857163,6278863,164607000,101136026
New York,1987,96919791,4887413,165186000,101807204
New York,1988,98240328,4349203,165632000,102589531
New York,1989,99120092,5061378,165662000,104181470
New York,1990,100309268,5654384,168945923,105963652
New York,1991,97291281,7677005,169198955,104968286
New York,1992,95893068,9119098,169393603,105012166
New York,1993,96491597,8315922,169892250,104807519
New York,1994,97009298,7219746,170122897,104229044
New York,1995,97433144,6586996,170338545,104020140
New York,1996,98919125,6596894,170835190,105516019
New York,1997,101388113,6936591,171533839,108324704
New York,1998,102809017,6087697,172609485,108896714
New York,1999,103731943,5666473,173678132,109398416
New York,2000,104731065,4947885,174567980,109678950
New York,2001,104159962,5349831,175706612,109509793
New York,2002,104633844,6916989,176823761,111550833
New York,2003,104262976,7135788,177942048,111398764
New York,2004,105761269,6507833,179041111,112269102
New York,2005,107862721,5626588,180098919,113489309
New York,2006,109067072,5176392,181202888,114243464
New York,2007,109074740,5064365,182303061,114139105
New York,2008,109442199,6258189,183268226,115700388
New York,2009,106287324,9707519,184251972,115994843
New York,2010,105501137,10066021,184594319,115567158
New York,2011,104875661,9558952,185691162,114434613
New York,2012,105308553,9937687,186776528,115246240
New York,2013,106597483,9018351,187671001,115615834
New York,2014,107114607,7177116,188290944,114291723
New York,2015,108446161,5995217,188616414,114441378
New York,2016,108758698,5578255,188748648,114336953
New York,2017,112583573,5473729,194113399,118057302
New York,2018,113063759,4829989,194611939,117893748
New York,2019,113731004,4555857,194867242,118286861
New York,2020,103666510,11256066,194714139,114922576
New York,2021,106674760,8055233,192936476,114729993
New York,2022,110494834,4903286,191615883,115398120
New York city,1976,32795141,4095040,68149000,36890181
New York city,1977,32983744,3746530,67419000,36730274
New York city,1978,33412013,3291429,66740000,36703442
New York city,1979,33614971,3175104,66301000,36790075
New York city,1980,33622987,3108776,66290000,36731763
New York city,1981,33787216,3283370,66764000,37070586
New York city,1982,33441347,3601010,67277000,37042357
New York city,1983,33225379,3619598,68005000,36844977
New York city,1984,33831422,3313390,68629000,37144812
New York city,1985,35391643,3113925,69021900,38505568
New York city,1986,36031501,2847079,69608700,38878580
New York city,1987,36699511,2163983,69968400,38863494
New York city,1988,36890139,1982732,70023600,38872871
New York city,1989,37408025,2577638,70135700,39985663
New York city,1990,37345120,2746883,70202052,40092003
New York city,1991,35912247,3493787,70214660,39406034
New York city,1992,35421327,4418996,70247580,39840323
New York city,1993,35571587,4108318,70559600,39679905
New York city,1994,35964097,3462773,70830221,39426870
New York city,1995,36339422,3242542,71139052,39581964
New York city,1996,37206983,3572651,71612272,40779634
New York city,1997,38351232,3944253,72201792,42295485
New York city,1998,39385177,3361916,72931312,42747093
New York city,1999,40218308,2956591,73653932,43174899
New York city,2000,41375635,2526245,74475341,43901880
New York city,2001,41142847,2661653,74974417,43804500
New York city,2002,41068972,3579299,75382525,44648271
New York city,2003,40811432,3675590,75834699,44487022
New York city,2004,41972498,3128452,76376282,45100950
New York city,2005,43036767,2572161,77005721,45608928
New York city,2006,43664628,2256791,77636812,45921419
New York city,2007,44051208,2247753,78343247,46298961
New York city,2008,44702619,2652571,78854158,47355190
New York city,2009,43294753,4419132,79311494,47713885
New York city,2010,43192237,4579964,78976279,47772201
New York city,2011,43333601,4357309,79510129,47690910
New York city,2012,43708564,4550763,80284210,48259327
New York city,2013,44506915,4292936,80837397,48799851
New York city,2014,45619084,3470180,81273616,49089264
New York city,2015,46332945,2736914,81582265,49069859
New York city,2016,46534522,2525913,81715842,49060435
New York city,2017,49260887,2330239,85077304,51591126
New York city,2018,49036773,2116761,85266315,51153534
New York city,2019,49188787,2016909,85319646,51205696
New York city,2020,42932232,5984030,84753178,48916262
New York city,2021,44198953,4921819,82414285,49120772
New York city,2022,46423708,2756473,81095148,49180181
North Carolina,1976,29351143,1940057,47248000,31291200
North Carolina,1977,30316373,1898340,48328000,32214713
North Carolina,1978,31670867,1505534,49358000,33176401
North Carolina,1979,32077373,1629435,50370000,33706808
North Carolina,1980,32081603,2200499,51515000,34282102
North Carolina,1981,32581985,2236952,52410000,34818937
North Carolina,1982,32041322,3263638,53229000,35304960
North Carolina,1983,32309940,3145820,53877000,35455760
North Carolina,1984,33989746,2398213,54860000,36387959
North Carolina,1985,35212622,2105674,56018000,37318296
North Carolina,1986,36222489,2028180,56769000,38250669
North Carolina,1987,37484329,1789516,57667000,39273845
North Carolina,1988,38487518,1478515,58503000,39966033
North Carolina,1989,39251968,1455373,59253000,40707341
North Carolina,1990,40008887,1721239,61154546,41730126
North Carolina,1991,39959309,2511273,62312133,42470582
North Carolina,1992,40531518,2699486,63261273,43231004
North Carolina,1993,41253904,2221346,64528413,43475250
North Carolina,1994,42204683,1948399,65828553,44153082
North Carolina,1995,43081974,1968582,67224693,45050556
North Carolina,1996,44546426,2024200,68642833,46570626
North Carolina,1997,45729524,1823093,69973973,47552617
North Carolina,1998,46001621,1683904,71294113,47685525
North Carolina,1999,46949044,1597489,72480253,48546533
North Carolina,2000,47688942,1860651,73378512,49549593
North Carolina,2001,47470426,2826526,74432803,50296952
North Carolina,2002,47007040,3499661,75433935,50506701
North Carolina,2003,47962745,3454301,76360507,51417046
North Carolina,2004,48437350,3016507,77426983,51453857
North Carolina,2005,49260528,2922851,78851995,52183379
North Carolina,2006,50776170,2749839,80662344,53526009
North Carolina,2007,51586391,2774398,82557852,54360789
North Carolina,2008,51542287,3414348,84143152,54956635
North Carolina,2009,49277061,6106844,85413939,55383905
North Carolina,2010,49631157,5956226,87540778,55587383
North Carolina,2011,50171770,5720396,89002421,55892166
North Carolina,2012,51251728,5381619,90053405,56633347
North Carolina,2013,52045217,4370470,91145092,56415687
North Carolina,2014,52937468,3448788,92260957,56386256
North Carolina,2015,53930859,3231291,93513582,57162150
North Carolina,2016,55179137,2961485,94941522,58140622
North Carolina,2017,55752157,2640113,95187062,58392270
North Carolina,2018,56591347,2363065,96389092,58954412
North Carolina,2019,57606384,2314610,97543148,59920994
North Carolina,2020,53874203,4183025,98693712,58057228
North Carolina,2021,56561422,2899574,100069330,59460996
North Carolina,2022,59658227,2268301,101610542,61926528
North Dakota,1976,3237180,126830,5355000,3364010
North Dakota,1977,3310571,154134,5441000,3464705
North Dakota,1978,3395757,146453,5505000,3542210
North Dakota,1979,3456449,150612,5562000,3607061
North Dakota,1980,3465135,178158,5605000,3643293
North Dakota,1981,3532052,182681,5676000,3714733
North Dakota,1982,3557298,210710,5751000,3768008
North Dakota,1983,3601816,225332,5843000,3827148
North Dakota,1984,3680211,207775,5871000,3887986
North Dakota,1985,3735687,215988,5839000,3951675
North Dakota,1986,3757202,221393,5838000,3978595
North Dakota,1987,3774622,196260,5803000,3970882
North Dakota,1988,3785940,182532,5779000,3968472
North Dakota,1989,3784147,168918,5729000,3953065
North Dakota,1990,3644448,156735,5561205,3801183
North Dakota,1991,3632913,165374,5567984,3798287
North Dakota,1992,3632115,174071,5594345,3806186
North Dakota,1993,3696180,165140,5640708,3861320
North Dakota,1994,3908645,149644,5691076,4058289
North Dakota,1995,3961708,135268,5742444,4096976
North Dakota,1996,4035968,130766,5800812,4166734
North Dakota,1997,4064636,123898,5829173,4188534
North Dakota,1998,4042872,123000,5836536,4165872
North Dakota,1999,3983646,129875,5827904,4113521
North Dakota,2000,3992718,121209,5820314,4113927
North Dakota,2001,3992841,116649,5813602,4109490
North Dakota,2002,3970661,139242,5816410,4109903
North Dakota,2003,4020733,144013,5827587,4164746
North Dakota,2004,4100231,142946,5873355,4243177
North Dakota,2005,4135413,141538,5899903,4276951
North Dakota,2006,4216502,135629,5926796,4352131
North Dakota,2007,4278244,133331,5950244,4411575
North Dakota,2008,4323725,138593,5987798,4462318
North Dakota,2009,4270555,174401,6044598,4444956
North Dakota,2010,4380587,167849,6252498,4548436
North Dakota,2011,4492850,155527,6398634,4648377
North Dakota,2012,4606749,139553,6534998,4746302
North Dakota,2013,4679324,139008,6703599,4818332
North Dakota,2014,4784779,128880,6844953,4913659
North Dakota,2015,4791930,138089,6961959,4930019
North Dakota,2016,4789191,153271,6973271,4942462
North Dakota,2017,4858854,130064,7053933,4988918
North Dakota,2018,4826043,118615,7079659,4944658
North Dakota,2019,4856936,107559,7113421,4964495
North Dakota,2020,4672396,244933,7144204,4917329
North Dakota,2021,4756712,150778,7155060,4907490
North Dakota,2022,4867037,104073,7183087,4971110
Ohio,1976,52639468,4410305,92772000,57049773
Ohio,1977,54214143,3746120,93746000,57960263
Ohio,1978,56180943,3287500,94692000,59468443
Ohio,1979,57138927,3563618,95382000,60702545
Ohio,1980,55769098,5070120,95928000,60839218
Ohio,1981,55497521,5867769,96404000,61365290
Ohio,1982,53727262,7727128,96545000,61454390
Ohio,1983,53744076,7577127,96393000,61321203
Ohio,1984,55506451,5804340,96481000,61310791
Ohio,1985,56195358,5506145,96889000,61701503
Ohio,1986,57449169,5217546,97225000,62666715
Ohio,1987,58693501,4483594,97955000,63177095
Ohio,1988,60064871,3846929,98768000,63911800
Ohio,1989,61259925,3625075,99134000,64885000
Ohio,1990,61127574,3757011,98775276,64884585
Ohio,1991,60780114,4246906,99570322,65027020
Ohio,1992,61074294,4881155,100115152,65955449
Ohio,1993,61705830,4402334,100753983,66108164
Ohio,1994,63007484,3775837,101208814,66783321
Ohio,1995,63963828,3271848,101767643,67235676
Ohio,1996,64555710,3395961,102275474,67951671
Ohio,1997,65446400,3174498,102575305,68620898
Ohio,1998,65598417,2982268,102887135,68580685
Ohio,1999,66118049,2991985,103160965,69110034
Ohio,2000,66544457,2849621,103477322,69394078
Ohio,2001,66781977,3061734,104006388,69843711
Ohio,2002,65902337,4052816,104514160,69955153
Ohio,2003,65967660,4368130,105016692,70335790
Ohio,2004,65824385,4387344,105412536,70211729
Ohio,2005,66392412,4177165,105837509,70569577
Ohio,2006,67624295,3861840,106311810,71486135
Ohio,2007,68158079,4049083,106793810,72207162
Ohio,2008,67289997,4754153,107157029,72044150
Ohio,2009,63688867,7188287,107446833,70877154
Ohio,2010,63207565,7236470,107643926,70444035
Ohio,2011,63168686,6121872,107960286,69290558
Ohio,2012,63479516,5075381,108282562,68554897
Ohio,2013,63395138,5089903,108720021,68485041
Ohio,2014,64573341,3981588,109167031,68554929
Ohio,2015,65153438,3390946,109525692,68544384
Ohio,2016,65571598,3496604,109900410,69068202
Ohio,2017,66340477,3466150,110836550,69806627
Ohio,2018,66704550,3144219,111214942,69848769
Ohio,2019,67599905,2945543,111580146,70545448
Ohio,2020,63335824,5697682,112024290,69033506
Ohio,2021,65224388,3530757,111985184,68755145
Ohio,2022,66140433,2768913,112071922,68909346
Oklahoma,1976,13505130,799680,24247000,14304810
Oklahoma,1977,14157535,709785,24787000,14867320
Oklahoma,1978,14726054,504844,25346000,15230898
Oklahoma,1979,15248834,486216,25955000,15735050
Oklahoma,1980,15742687,677401,26623000,16420088
Oklahoma,1981,16559838,611557,27261000,17171395
Oklahoma,1982,16772301,1087460,28202000,17859761
Oklahoma,1983,16889880,1489457,28996000,18379337
Oklahoma,1984,17298822,1261057,29074000,18559879
Oklahoma,1985,17362079,1323283,28875000,18685362
Oklahoma,1986,17394361,1577318,29033000,18971679
Oklahoma,1987,17287030,1333570,28816000,18620600
Oklahoma,1988,17143579,1156696,28628000,18300275
Oklahoma,1989,17246683,1051603,28636000,18298286
Oklahoma,1990,17255680,982649,28161425,18238329
Oklahoma,1991,17065800,1088147,28366911,18153947
Oklahoma,1992,17236128,1076246,28672097,18312374
Oklahoma,1993,17377927,1042356,28960283,18420283
Oklahoma,1994,17637868,985645,29208468,18623513
Oklahoma,1995,17893886,834399,29449655,18728285
Oklahoma,1996,18272768,761636,29784840,19034404
Oklahoma,1997,18541089,761605,30113026,19302694
Oklahoma,1998,18821234,801093,30424212,19622327
Oklahoma,1999,19174810,690879,30739397,19865689
Oklahoma,2000,19275005,596998,30959678,19872003
Oklahoma,2001,19336759,728655,31123039,20065414
Oklahoma,2002,19293593,936137,31334765,20229730
Oklahoma,2003,19144005,1092230,31513565,20236235
Oklahoma,2004,19324171,955301,31657385,20279472
Oklahoma,2005,19621290,888156,31897555,20509446
Oklahoma,2006,19768577,806536,32283507,20575113
Oklahoma,2007,19863017,818491,32600849,20681508
Oklahoma,2008,20136776,755886,32918366,20892662
Oklahoma,2009,19847048,1394278,33288952,21241326
Oklahoma,2010,19804653,1375236,33992514,21179889
Oklahoma,2011,20019464,1184758,34415408,21204222
Oklahoma,2012,20444880,1096953,34732520,21541833
Oklahoma,2013,20494092,1106285,35052439,21600377
Oklahoma,2014,20641018,936343,35347995,21577361
Oklahoma,2015,21006389,941564,35660129,21947953
Oklahoma,2016,20915873,1019560,35884097,21935433
Oklahoma,2017,21034485,883191,35848658,21917676
Oklahoma,2018,21249843,722897,35968475,21972740
Oklahoma,2019,21388282,691246,36172465,22079528
Oklahoma,2020,20700498,1393331,36463101,22093829
Oklahoma,2021,21431517,900380,36779147,22331897
Oklahoma,2022,21954039,683373,37130034,22637412
Oregon,1976,11933041,1219392,20875000,13152433
Oregon,1977,12802356,1026797,21604000,13829153
Oregon,1978,13622835,888672,22346000,14511507
Oregon,1979,13958053,1005698,23081000,14963751
Oregon,1980,14177788,1303866,23687000,15481654
Oregon,1981,14383639,1541627,23979000,15925266
Oregon,1982,14117413,1809036,24039000,15926449
Oregon,1983,14329373,1742046,24093000,16071419
Oregon,1984,14513895,1489044,24274000,16002939
Oregon,1985,14546180,1378770,24327000,15924950
Oregon,1986,15063208,1299501,24666000,16362709
Oregon,1987,15700814,1027382,25013000,16728196
Oregon,1988,16193225,982602,25463000,17175827
Oregon,1989,16681276,940345,25917000,17621621
Oregon,1990,16970996,967868,26326097,17938864
Oregon,1991,17074767,1126584,26928048,18201351
Oregon,1992,17334384,1359309,27514000,18693693
Oregon,1993,17880021,1344267,28195952,19224288
Oregon,1994,18659780,1045390,28782904,19705170
Oregon,1995,19010892,950177,29376856,19961069
Oregon,1996,19411168,1143552,30006808,20554720
Oregon,1997,19788144,1160447,30533760,20948591
Oregon,1998,20130814,1204250,30977712,21335064
Oregon,1999,20273914,1175822,31364663,21449736
Oregon,2000,20615952,1132752,31710508,21748704
Oregon,2001,20394162,1388935,32157838,21783097
Oregon,2002,20366683,1646604,32649569,22013287
Oregon,2003,20368849,1778502,33057521,22147351
Oregon,2004,20518193,1623461,33382206,22141654
Oregon,2005,20817070,1370841,33882155,22187911
Oregon,2006,21364127,1216739,34518318,22580866
Oregon,2007,21748284,1183926,35113098,22932210
Oregon,2008,21896850,1468443,35645187,23365293
Oregon,2009,21072527,2552819,36096021,23625346
Oregon,2010,21337939,2555085,36412251,23893024
Oregon,2011,21649184,2299566,36802808,23948750
Oregon,2012,21498734,2078428,37176728,23577162
Oregon,2013,21311375,1791131,37516793,23102506
Oregon,2014,21842509,1552776,37973263,23395285
Oregon,2015,22461379,1295407,38575234,23756786
Oregon,2016,23348097,1163595,39352018,24511692
Oregon,2017,23904248,1011545,39932073,24915793
Oregon,2018,23960664,1004791,40399153,24965455
Oregon,2019,24197666,935996,40825472,25133662
Oregon,2020,23358971,1920735,41289657,25279706
Oregon,2021,24440014,1344027,41564487,25784041
Oregon,2022,25027823,1080374,41594062,26108197
Pennsylvania,1976,56721410,4939906,105686000,61661316
Pennsylvania,1977,57725605,4842537,106548000,62568142
Pennsylvania,1978,59185340,4448604,107267000,63633944
Pennsylvania,1979,60010507,4501676,108022000,64512183
Pennsylvania,1980,59986244,5317757,108592000,65304001
Pennsylvania,1981,60138677,5483772,109284000,65622449
Pennsylvania,1982,58608150,7169531,109752000,65777681
Pennsylvania,1983,58397006,7301545,110117000,65698551
Pennsylvania,1984,60015222,5884211,110342000,65899433
Pennsylvania,1985,61248353,5328109,110444000,66576462
Pennsylvania,1986,62762941,4715949,110922000,67478890
Pennsylvania,1987,64046058,3912816,111570000,67958874
Pennsylvania,1988,65583057,3552580,112101000,69135637
Pennsylvania,1989,66587346,3425589,112401000,70012935
Pennsylvania,1990,65917210,3838844,110471024,69756054
Pennsylvania,1991,65280006,4850099,111088420,70130105
Pennsylvania,1992,65469737,5274487,111410267,70744224
Pennsylvania,1993,65873771,4901471,111866112,70775242
Pennsylvania,1994,66231559,4471257,112214952,70702816
Pennsylvania,1995,66641499,4169858,112539792,70811357
Pennsylvania,1996,67883070,3944498,112910632,71827568
Pennsylvania,1997,68993957,3739440,113051479,72733397
Pennsylvania,1998,69386204,3406317,113275324,72792521
Pennsylvania,1999,69862391,3270094,113598164,73132485
Pennsylvania,2000,70189152,3094821,113835505,73283973
Pennsylvania,2001,70578454,3555469,114190108,74133923
Pennsylvania,2002,70429846,4135373,114708285,74565219
Pennsylvania,2003,69684860,4207467,115282677,73892327
Pennsylvania,2004,70537246,4003225,115796185,74540471
Pennsylvania,2005,71333070,3748378,116427324,75081448
Pennsylvania,2006,72024436,3553676,117215181,75578112
Pennsylvania,2007,72703158,3466176,117953294,76169334
Pennsylvania,2008,73150298,4137850,118660768,77288148
Pennsylvania,2009,70708595,6126606,119272493,76835201
Pennsylvania,2010,70072255,6233755,120589576,76306010
Pennsylvania,2011,70632993,5934904,121429274,76567897
Pennsylvania,2012,71469884,5925996,121878745,77395880
Pennsylvania,2013,71571931,5482159,122172767,77054090
Pennsylvania,2014,72115983,4551774,122467870,76667757
Pennsylvania,2015,72928296,4154203,122620354,77082499
Pennsylvania,2016,73379166,4137190,122789595,77516356
Pennsylvania,2017,73931174,3873027,124284305,77804201
Pennsylvania,2018,74659853,3454502,124663862,78114355
Pennsylvania,2019,75457277,3412498,124938790,78869775
Pennsylvania,2020,71176715,6961979,125499155,78138694
Pennsylvania,2021,72715933,4670973,125952292,77386906
Pennsylvania,2022,74345529,3374983,125889754,77720512
Rhode Island,1976,4874029,423521,8349000,5297550
Rhode Island,1977,4951959,433575,8473000,5385534
Rhode Island,1978,5067519,341595,8572000,5409114
Rhode Island,1979,5209789,351766,8628000,5561555
Rhode Island,1980,5241964,409742,8639000,5651706
Rhode Island,1981,5287634,432473,8717000,5720107
Rhode Island,1982,5211704,578036,8779000,5789740
Rhode Island,1983,5283499,487677,8825000,5771176
Rhode Island,1984,5548667,311357,8900000,5860024
Rhode Island,1985,5704062,278701,8976000,5982763
Rhode Island,1986,5823743,246759,9051000,6070502
Rhode Island,1987,5942273,228273,9147000,6170546
Rhode Island,1988,6018074,182929,9209000,6201003
Rhode Island,1989,5984478,242385,9236000,6226863
Rhode Island,1990,5888992,392495,9310216,6281487
Rhode Island,1991,5772951,531123,9356393,6304074
Rhode Island,1992,5790481,571731,9353704,6362212
Rhode Island,1993,5807479,473583,9362013,6281062
Rhode Island,1994,5766397,410111,9381323,6176508
Rhode Island,1995,5752201,388220,9408631,6140421
Rhode Island,1996,5897648,324278,9471942,6221926
Rhode Island,1997,6038953,339307,9530250,6378260
Rhode Island,1998,6095650,290732,9607561,6386382
Rhode Island,1999,6207955,271936,9676869,6479891
Rhode Island,2000,6250951,260984,9751527,6511935
Rhode Island,2001,6210537,289341,9835218,6499878
Rhode Island,2002,6268021,336714,9935136,6604735
Rhode Island,2003,6352745,374824,10014299,6727569
Rhode Island,2004,6317287,350027,10049930,6667314
Rhode Island,2005,6414019,346080,10045716,6760099
Rhode Island,2006,6500245,359013,10050390,6859258
Rhode Island,2007,6502809,349889,10050132,6852698
Rhode Island,2008,6302366,518041,10061213,6820407
Rhode Island,2009,6073023,782114,10100816,6855137
Rhode Island,2010,6059653,796619,10112817,6856272
Rhode Island,2011,6000752,743029,10133553,6743781
Rhode Island,2012,6035754,688011,10176006,6723765
Rhode Island,2013,6071231,635007,10209381,6706238
Rhode Island,2014,6162030,518980,10244592,6681010
Rhode Island,2015,6260549,401211,10271261,6661760
Rhode Island,2016,6294070,346976,10297903,6641046
Rhode Island,2017,6509224,307327,10586904,6816551
Rhode Island,2018,6594236,277898,10652322,6872134
Rhode Island,2019,6648574,243509,10702945,6892083
Rhode Island,2020,6214041,627601,10762247,6841642
Rhode Island,2021,6481343,378152,10794253,6859495
Rhode Island,2022,6619429,219681,10796655,6839110
South Carolina,1976,14497582,1093323,24089000,15590905
South Carolina,1977,14849175,1074332,24735000,15923507
South Carolina,1978,15384058,907372,25412000,16291430
South Carolina,1979,15675052,822241,26033000,16497293
South Carolina,1980,15627041,1126661,26655000,16753702
South Carolina,1981,15780821,1401144,27199000,17181965
South Carolina,1982,15870207,1916790,27688000,17786997
South Carolina,1983,15998203,1752470,28093000,17750673
South Carolina,1984,16699792,1246703,28542000,17946495
South Carolina,1985,17321080,1265166,29118000,18586246
South Carolina,1986,17892716,1217965,29464000,19110681
South Carolina,1987,18506564,1072332,29944000,19578896
South Carolina,1988,19007725,923043,30396000,19930768
South Carolina,1989,19381734,937997,30792000,20319731
South Carolina,1990,19832310,1022767,31342115,20855077
South Carolina,1991,19911746,1294618,31965106,21206364
South Carolina,1992,20142921,1455323,32396936,21598244
South Carolina,1993,20324004,1599030,32873764,21923034
South Carolina,1994,20731299,1360805,33300588,22092104
South Carolina,1995,21222728,1143584,33767420,22366312
South Carolina,1996,21354551,1283562,34213242,22638113
South Carolina,1997,22015811,1031192,34774072,23047003
South Carolina,1998,22447711,846114,35349900,23293825
South Carolina,1999,22529122,973921,35874724,23503043
South Carolina,2000,22711154,879171,36328404,23590325
South Carolina,2001,22067744,1228720,36770286,23296464
South Carolina,2002,21950207,1509378,37184870,23459585
South Carolina,2003,22262031,1727913,37606978,23989944
South Carolina,2004,22697229,1822274,38143741,24519503
South Carolina,2005,23038319,1812966,38808582,24851285
South Carolina,2006,24011936,1774451,39665239,25786387
South Carolina,2007,24298607,1563605,40494574,25862212
South Carolina,2008,24028401,1896014,41279685,25924415
South Carolina,2009,23042564,2965579,41885374,26008143
South Carolina,2010,23139259,2947557,42775426,26086816
South Carolina,2011,23488714,2736225,43344577,26224939
South Carolina,2012,23917252,2369494,43866180,26286746
South Carolina,2013,24420033,1958869,44451370,26378902
South Carolina,2014,24995151,1676132,45108018,26671283
South Carolina,2015,25615146,1603998,45868908,27219144
South Carolina,2016,26088969,1346120,46656061,27435089
South Carolina,2017,26001109,1139616,46771737,27140725
South Carolina,2018,26456913,922692,47381373,27379605
South Carolina,2019,27120455,776377,48031209,27896832
South Carolina,2020,26334082,1677956,48750676,28012038
South Carolina,2021,27136034,1121133,49489508,28257167
South Carolina,2022,27573906,924237,50451800,28498143
South Dakota,1976,3602715,123519,5767000,3726234
South Dakota,1977,3679098,128682,5839000,3807780
South Dakota,1978,3751052,122632,5880000,3873684
South Dakota,1979,3791934,131508,5915000,3923442
South Dakota,1980,3795843,188018,5944000,3983861
South Dakota,1981,3813283,193034,5961000,4006317
South Dakota,1982,3787286,217556,5984000,4004842
South Dakota,1983,3827542,210106,6044000,4037648
South Dakota,1984,3910632,179102,6086000,4089734
South Dakota,1985,3952287,200523,6075000,4152810
South Dakota,1986,4006638,194344,6135000,4200982
South Dakota,1987,4050435,182149,6181000,4232584
South Dakota,1988,4108517,175676,6221000,4284193
South Dakota,1989,4163881,167046,6228000,4330927
South Dakota,1990,4038872,152543,6011187,4191415
South Dakota,1991,4101422,149417,6064720,4250839
South Dakota,1992,4180994,150037,6132512,4331031
South Dakota,1993,4253516,152903,6236304,4406419
South Dakota,1994,4370414,148072,6350096,4518486
South Dakota,1995,4468701,146823,6451888,4615524
South Dakota,1996,4531785,153746,6543680,4685531
South Dakota,1997,4588220,139137,6587472,4727357
South Dakota,1998,4640619,136106,6621264,4776725
South Dakota,1999,4710168,131492,6677056,4841660
South Dakota,2000,4777781,124305,6738764,4902086
South Dakota,2001,4811694,149018,6796309,4960712
South Dakota,2002,4841020,161748,6853661,5002768
South Dakota,2003,4881930,175270,6915044,5057200
South Dakota,2004,4927205,184061,6994312,5111266
South Dakota,2005,4968432,182571,7074123,5151003
South Dakota,2006,5037222,156189,7166835,5193411
South Dakota,2007,5088052,148436,7257875,5236488
South Dakota,2008,5107140,163410,7337529,5270550
South Dakota,2009,5055093,242405,7411318,5297498
South Dakota,2010,5062071,261546,7431688,5323617
South Dakota,2011,5103932,245669,7486051,5349601
South Dakota,2012,5147999,217484,7580688,5365483
South Dakota,2013,5172028,199119,7664113,5371147
South Dakota,2014,5228730,179907,7725843,5408637
South Dakota,2015,5272165,165321,7779217,5437486
South Dakota,2016,5296376,164862,7857122,5461238
South Dakota,2017,5297169,166647,7901525,5463816
South Dakota,2018,5356459,154120,7960612,5510579
South Dakota,2019,5416386,155210,8033983,5571596
South Dakota,2020,5337167,235576,8108706,5572743
South Dakota,2021,5486946,149218,8207789,5636164
South Dakota,2022,5582611,117658,8354578,5700269
Tennessee,1976,20957016,1360839,37355000,22317855
Tennessee,1977,21794626,1454048,38258000,23248674
Tennessee,1978,22347360,1384405,39050000,23731765
Tennessee,1979,23022362,1431217,39965000,24453579
Tennessee,1980,23059123,1798403,40788000,24857526
Tennessee,1981,23106639,2257133,41301000,25363772
Tennessee,1982,22615436,2990023,41717000,25605459
Tennessee,1983,23146965,3047980,42059000,26194945
Tennessee,1984,24359452,2358603,42504000,26718055
Tennessee,1985,24890340,2142309,43148000,27032649
Tennessee,1986,25341881,2176369,43545000,27518250
Tennessee,1987,26091313,1869530,44163000,27960843
Tennessee,1988,26393789,1620502,44648000,28014291
Tennessee,1989,26914711,1445591,45031000,28360302
Tennessee,1990,27237449,1536238,45184754,28773687
Tennessee,1991,27114635,1918336,45870107,29032971
Tennessee,1992,27708267,1909463,46509797,29617730
Tennessee,1993,28647807,1777342,47238488,30425149
Tennessee,1994,30353198,1528201,48039179,31881399
Tennessee,1995,31001481,1684283,48906870,32685764
Tennessee,1996,31441050,1711456,49801562,33152506
Tennessee,1997,31616195,1754578,50627253,33370773
Tennessee,1998,32267655,1461082,51271943,33728737
Tennessee,1999,32777817,1352213,51810634,34130030
Tennessee,2000,32867974,1324218,52300786,34192192
Tennessee,2001,32740119,1549971,52814445,34290090
Tennessee,2002,33004498,1781387,53338447,34785885
Tennessee,2003,32939189,1919860,53907061,34859049
Tennessee,2004,32890698,1859102,54498973,34749800
Tennessee,2005,32868280,1920536,55321402,34788816
Tennessee,2006,34263977,1910526,56308708,36174503
Tennessee,2007,34827112,1693043,57120885,36520155
Tennessee,2008,34335876,2397500,57859980,36733376
Tennessee,2009,32717469,3685113,58421287,36402582
Tennessee,2010,33477151,3643960,59104674,37121111
Tennessee,2011,33995716,3407768,59681593,37403484
Tennessee,2012,34194891,2961432,60244213,37156323
Tennessee,2013,34097454,2854967,60774898,36952421
Tennessee,2014,34108367,2414929,61318272,36523296
Tennessee,2015,34840533,2052145,61910382,36892678
Tennessee,2016,35849039,1791863,62567236,37640902
Tennessee,2017,36922153,1435035,63419184,38357188
Tennessee,2018,37729707,1362506,64112350,39092213
Tennessee,2019,38687861,1337577,64768533,40025438
Tennessee,2020,36652387,2964559,65602339,39616946
Tennessee,2021,38114831,1793722,66280338,39908553
Tennessee,2022,38883673,1357702,67143670,40241375
Texas,1976,64514177,3996367,107492000,68510544
Texas,1977,67661194,3873704,110918000,71534898
Texas,1978,71099093,3653310,114425000,74752403
Texas,1979,74464796,3435412,118449000,77900208
Texas,1980,76898829,4250184,122670000,81149013
Texas,1981,80401170,4544896,126665000,84946066
Texas,1982,82228268,6111605,131522000,88339873
Texas,1983,84190529,7369242,135434000,91559771
Texas,1984,88732795,5820710,138341000,94553505
Texas,1985,90172344,6810910,141027000,96983254
Texas,1986,89491549,8600327,143274000,98091876
Texas,1987,90849689,8454684,144205000,99304373
Texas,1988,92778556,7441113,144918000,100219669
Texas,1989,94620864,6806160,146592000,101427024
Texas,1990,96701839,6593119,151252820,103294958
Texas,1991,97905751,7338694,153686500,105244445
Texas,1992,99694557,8299855,156424096,107994412
Texas,1993,102073511,7939736,159527690,110013247
Texas,1994,105344156,7403829,162689284,112747985
Texas,1995,107886563,7026414,165785880,114912977
Texas,1996,110025670,6715174,168869475,116740844
Texas,1997,112577023,6415404,172219069,118992427
Texas,1998,115382084,6019387,175659664,121401471
Texas,1999,117412596,5808168,179104259,123220764
Texas,2000,119195732,5469312,182406682,124665044
Texas,2001,120161623,6282353,185938283,126443976
Texas,2002,120737998,8182162,189369357,128920160
Texas,2003,122102227,8810606,192601300,130912833
Texas,2004,124015416,7925113,195872542,131940529
Texas,2005,126744116,7323528,199476065,134067644
Texas,2006,129224901,6800678,204058157,136025579
Texas,2007,131311406,5988115,208685944,137299521
Texas,2008,133305248,6840941,212884204,140146189
Texas,2009,132573296,10804995,217092350,143378291
Texas,2010,135066543,12034558,222805792,147101101
Texas,2011,137981810,12019105,227610813,150000915
Texas,2012,141549227,10147626,231939785,151696853
Texas,2013,144302810,9695082,236234287,153997892
Texas,2014,147999581,8082111,241037256,156081692
Texas,2015,150073709,7029143,246110960,157102852
Texas,2016,152731942,7445753,250860079,160177695
Texas,2017,154646901,7032858,253620960,161679759
Texas,2018,158118285,6435192,257316729,164553477
Texas,2019,161182225,5900049,261313176,167082274
Texas,2020,154517887,12877850,266051243,167395737
Texas,2021,162071624,9693667,270416654,171765291
Texas,2022,169079935,6819018,275552799,175898953
Utah,1976,5951560,353300,10037000,6304860
Utah,1977,6212070,341215,10392000,6553285
Utah,1978,6568016,263989,10761000,6832005
Utah,1979,6961311,320759,11149000,7282070
Utah,1980,7110964,475390,11540000,7586354
Utah,1981,7272273,518229,11875000,7790502
Utah,1982,7403835,654144,12200000,8057979
Utah,1983,7540255,746745,12549000,8287000
Utah,1984,7938777,558393,12601000,8497170
Utah,1985,8267109,532598,12750000,8799707
Utah,1986,8467970,555723,12923000,9023693
Utah,1987,8503132,567467,13041000,9070599
Utah,1988,8662772,451994,13161000,9114766
Utah,1989,9009333,434643,13318000,9443976
Utah,1990,9391240,430351,13908189,9821591
Utah,1991,9690799,482743,14425549,10173542
Utah,1992,10072890,514651,15007122,10587541
Utah,1993,10790215,455589,15641694,11245804
Utah,1994,11495398,444915,16287267,11940313
Utah,1995,11804566,421500,16877839,12226066
Utah,1996,12082355,421081,17435412,12503436
Utah,1997,12435901,406744,17895984,12842645
Utah,1998,12771681,473148,18298557,13244829
Utah,1999,13015551,472482,18649129,13488033
Utah,2000,13257603,457925,18996710,13715528
Utah,2001,13341997,609663,19440998,13951660
Utah,2002,13353195,801299,19867357,14154494
Utah,2003,13567285,798937,20270549,14366222
Utah,2004,14039044,739576,20771141,14778620
Utah,2005,14745835,621456,21333328,15367291
Utah,2006,15542270,455772,22026481,15998042
Utah,2007,16109517,423762,22673707,16533279
Utah,2008,16070064,555520,23208151,16625584
Utah,2009,15295449,1196442,23669683,16491891
Utah,2010,14915869,1285774,23650994,16201643
Utah,2011,14960593,1136632,23897577,16097225
Utah,2012,15411172,772749,24310075,16183921
Utah,2013,15934718,700296,24756054,16635014
Utah,2014,16372579,617627,25191649,16990206
Utah,2015,16826038,617454,25690812,17443492
Utah,2016,17399185,603430,26323525,18002615
Utah,2017,18062460,587862,27121872,18650322
Utah,2018,18458381,555079,27752810,19013460
Utah,2019,18932388,493198,28382671,19425586
Utah,2020,18808021,955701,29112474,19763722
Utah,2021,19698215,555161,29833711,20253376
Utah,2022,20425294,483236,30439390,20908530
Vermont,1976,2399298,216319,4115000,2615617
Vermont,1977,2542553,191586,4219000,2734139
Vermont,1978,2696205,161836,4318000,2858041
Vermont,1979,2783733,146016,4424000,2929749
Vermont,1980,2816590,177517,4520000,2994107
Vermont,1981,2907948,180745,4582000,3088693
Vermont,1982,2937994,215940,4641000,3153934
Vermont,1983,2981425,208350,4700000,3189775
Vermont,1984,3090263,159285,4754000,3249548
Vermont,1985,3198030,153478,4821000,3351508
Vermont,1986,3311367,149879,4884000,3461246
Vermont,1987,3407449,132742,4959000,3540191
Vermont,1988,3482231,108254,5067000,3590485
Vermont,1989,3525170,132899,5157000,3658069
Vermont,1990,3509687,173366,5152823,3683053
Vermont,1991,3461903,218644,5188411,3680547
Vermont,1992,3506510,233160,5217919,3739670
Vermont,1993,3576693,196363,5263429,3773056
Vermont,1994,3622894,167160,5316937,3790054
Vermont,1995,3679317,159622,5377448,3838939
Vermont,1996,3737782,167417,5441956,3905199
Vermont,1997,3804967,156129,5505465,3961096
Vermont,1998,3874924,139148,5561975,4014072
Vermont,1999,3925572,124129,5621484,4049701
Vermont,2000,3896479,112971,5686975,4009450
Vermont,2001,3923483,133541,5744789,4057024
Vermont,2002,3961366,158270,5801519,4119636
Vermont,2003,3974162,181792,5855061,4155954
Vermont,2004,4014222,153361,5901752,4167583
Vermont,2005,4049188,145295,5945875,4194483
Vermont,2006,4105697,158333,5992984,4264030
Vermont,2007,4073363,166734,6027447,4240097
Vermont,2008,4054483,193392,6056618,4247875
Vermont,2009,4045517,266663,6085973,4312180
Vermont,2010,4043877,272663,6094137,4316540
Vermont,2011,4052690,238800,6123259,4291490
Vermont,2012,4043419,204269,6137900,4247688
Vermont,2013,4017570,185500,6153254,4203070
Vermont,2014,4017664,167344,6163791,4185008
Vermont,2015,4011059,147032,6178607,4158091
Vermont,2016,4020260,130012,6184924,4150272
Vermont,2017,4135687,128313,6333766,4264000
Vermont,2018,4158755,105643,6362117,4264398
Vermont,2019,4151757,89035,6389508,4240792
Vermont,2020,3844877,233049,6427640,4077926
Vermont,2021,3880991,148995,6478680,4029986
Vermont,2022,3997367,107756,6500924,4105123
Virginia,1976,26447822,1651130,42937000,28098952
Virginia,1977,27260245,1570151,44012000,28830396
Virginia,1978,28267710,1574361,45068000,29842071
Virginia,1979,28934258,1438208,45897000,30372466
Virginia,1980,29199189,1574837,46662000,30774026
Virginia,1981,29467697,1860466,47505000,31328163
Virginia,1982,29648709,2375488,48234000,32024197
Virginia,1983,30664377,2073800,48984000,32738177
Virginia,1984,32006369,1708489,49835000,33714858
Virginia,1985,32532822,1858595,50570000,34391417
Virginia,1986,33293296,1735083,51591000,35028379
Virginia,1987,34542585,1506243,52738000,36048828
Virginia,1988,35563547,1444178,53768000,37007725
Virginia,1989,36259276,1466313,54548000,37725589
Virginia,1990,37081072,1716936,55867353,38798008
Virginia,1991,37538793,2312408,56568338,39851201
Virginia,1992,38018878,2499960,57363718,40518838
Virginia,1993,38347617,2099109,58243100,40446726
Virginia,1994,39006520,1972322,59027482,40978842
Virginia,1995,39524138,1839095,59792862,41363233
Virginia,1996,39480057,1789811,60630243,41269868
Virginia,1997,40035355,1539678,61398625,41575033
Virginia,1998,40843095,1164231,62058006,42007326
Virginia,1999,41518638,1151987,62887387,42670625
Virginia,2000,42298168,986054,63654593,43284222
Virginia,2001,42710562,1454204,64551335,44164766
Virginia,2002,42922463,1959798,65444770,44882261
Virginia,2003,43302717,1958495,66219019,45261212
Virginia,2004,43894550,1868956,67389280,45763506
Virginia,2005,45084754,1798963,68471476,46883717
Virginia,2006,46124351,1592747,69462853,47717098
Virginia,2007,46884171,1590838,70295404,48475009
Virginia,2008,47422508,2122162,71120845,49544670
Virginia,2009,46254915,3388777,72010135,49643692
Virginia,2010,46310900,3648706,73731393,49959606
Virginia,2011,47142669,3313306,74922111,50455975
Virginia,2012,47609552,3008542,75835883,50618094
Virginia,2013,48040404,2832900,76597249,50873304
Virginia,2014,48491841,2615751,77294126,51107592
Virginia,2015,48576088,2225772,77940636,50801860
Virginia,2016,49020590,2038945,78522574,51059535
Virginia,2017,50316404,1913517,79499515,52229921
Virginia,2018,50728131,1572860,80044118,52300991
Virginia,2019,51508823,1459942,80627175,52968765
Virginia,2020,48734155,3377731,81239458,52111886
Virginia,2021,49955399,2018013,81645271,51973412
Virginia,2022,51697557,1508647,82074509,53206204
Washington,1976,17700761,1705485,31604000,19406246
Washington,1977,18755159,1714002,32628000,20469161
Washington,1978,20240307,1478258,33880000,21718565
Washington,1979,21494222,1565808,35283000,23060030
Washington,1980,21772424,1872680,36673000,23645104
Washington,1981,21834492,2249687,37459000,24084179
Washington,1982,21456054,2826491,37896000,24282545
Washington,1983,21832234,2752387,38241000,24584621
Washington,1984,22606972,2319342,38713000,24926314
Washington,1985,23207134,2079912,39105000,25287046
Washington,1986,24092600,2126034,39941000,26218634
Washington,1987,25155610,1976591,40785000,27132201
Washington,1988,26255773,1759008,41727000,28014781
Washington,1989,27635068,1734485,42657000,29369553
Washington,1990,28703821,1563028,44116303,30266849
Washington,1991,28840534,1872330,45147991,30712864
Washington,1992,29466201,2284944,46295011,31751145
Washington,1993,30047735,2359315,47452032,32407050
Washington,1994,30828136,2065792,48435053,32893928
Washington,1995,31549958,2096652,49423076,33646610
Washington,1996,32671704,2050048,50317097,34721752
Washington,1997,33885917,1758812,51278117,35644729
Washington,1998,34635815,1753229,52180139,36389044
Washington,1999,34990555,1771787,52908159,36762342
Washington,2000,35155091,1893175,53588302,37048266
Washington,2001,34803056,2220009,54411430,37023065
Washington,2002,34580947,2634725,55216575,37215672
Washington,2003,34909431,2715288,55931860,37624719
Washington,2004,35856982,2408161,56852043,38265143
Washington,2005,36930112,2189717,57807773,39119829
Washington,2006,37965954,1995004,58989474,39960958
Washington,2007,38945472,1877851,60067985,40823323
Washington,2008,39492019,2205109,61069842,41697128
Washington,2009,38132505,3438048,62089225,41570553
Washington,2010,37704866,3790917,62950371,41495783
Washington,2011,37746892,3519215,63736409,41266107
Washington,2012,38429589,3186096,64566257,41615685
Washington,2013,38779947,2748070,65300156,41528017
Washington,2014,39453232,2484655,66269728,41937887
Washington,2015,40346803,2315914,67432591,42662717
Washington,2016,41511441,2280551,68782536,43791992
Washington,2017,42650756,2073381,70213108,44724137
Washington,2018,43748942,2027595,71333297,45776537
Washington,2019,45207996,1997670,72359337,47205666
Washington,2020,43227924,4001599,73433727,47229523
Washington,2021,44350746,2440823,73977563,46791569
Washington,2022,45858967,1997497,74681310,47856464
West Virginia,1976,7885339,612443,16403000,8497782
West Virginia,1977,8030442,595963,16735000,8626405
West Virginia,1978,8264395,560234,16952000,8824629
West Virginia,1979,8403214,664499,17165000,9067713
West Virginia,1980,8310546,936668,17331000,9247214
West Virginia,1981,8327459,987535,17472000,9314994
West Virginia,1982,8048028,1314494,17559000,9362522
West Virginia,1983,7572430,1577303,17644000,9149733
West Virginia,1984,7816396,1283392,17617000,9099788
West Virginia,1985,7841263,1188817,17555000,9030080
West Virginia,1986,7883818,1081105,17468000,8964923
West Virginia,1987,7923405,977088,17397000,8900493
West Virginia,1988,8008635,884227,17287000,8892862
West Virginia,1989,8329829,796356,17177000,9126185
West Virginia,1990,8438317,796049,16781088,9234366
West Virginia,1991,8372171,997991,16904580,9370162
West Virginia,1992,8387292,1060710,16991796,9448002
West Virginia,1993,8442069,970788,17113007,9412857
West Virginia,1994,8612642,832410,17185222,9445052
West Virginia,1995,8687333,753558,17215438,9440891
West Virginia,1996,8765787,725381,17248652,9491168
West Virginia,1997,8827802,662441,17236864,9490243
West Virginia,1998,8905959,637907,17213080,9543866
West Virginia,1999,8972793,618940,17187295,9591733
West Virginia,2000,9054553,535428,17162042,9589981
West Virginia,2001,9042459,516188,17123675,9558647
West Virginia,2002,8966041,619058,17141462,9585099
West Virginia,2003,8877493,623485,17178981,9500978
West Virginia,2004,8926698,545511,17194123,9472209
West Virginia,2005,9015388,518742,17220910,9534130
West Virginia,2006,9157290,500515,17281095,9657805
West Virginia,2007,9188379,464414,17333222,9652793
West Virginia,2008,9218343,458931,17384138,9677274
West Virginia,2009,8929245,808694,17439131,9737939
West Virginia,2010,8880039,839302,17717480,9719341
West Virginia,2011,8919110,757093,17837857,9676203
West Virginia,2012,8996227,702494,17856258,9698721
West Virginia,2013,8951667,644267,17844271,9595934
West Virginia,2014,8926692,621421,17819076,9548113
West Virginia,2015,8874358,625054,17765916,9499412
West Virginia,2016,8845894,574809,17688474,9420703
West Virginia,2017,8924676,490954,17607725,9415630
West Virginia,2018,9029457,491369,17507729,9520826
West Virginia,2019,9074213,471331,17434316,9545544
West Virginia,2020,8583953,772357,17357933,9356310
West Virginia,2021,8870705,477599,17304794,9348304
West Virginia,2022,9052054,368780,17231130,9420834
Wisconsin,1976,24327911,1414741,39196000,25742652
Wisconsin,1977,24923739,1329842,39833000,26253581
Wisconsin,1978,25713145,1309967,40396000,27023112
Wisconsin,1979,26479673,1258928,41037000,27738601
Wisconsin,1980,26129455,2074659,41698000,28204114
Wisconsin,1981,26275859,2226606,42155000,28502465
Wisconsin,1982,26027593,2997062,42426000,29024655
Wisconsin,1983,26059674,2824001,42481000,28883675
Wisconsin,1984,26710473,2095960,42663000,28806433
Wisconsin,1985,26713094,2048525,42870000,28761619
Wisconsin,1986,27206435,1977814,43096000,29184249
Wisconsin,1987,28185416,1707617,43412000,29893033
Wisconsin,1988,29254126,1340461,43788000,30594587
Wisconsin,1989,29795948,1334651,44034000,31130599
Wisconsin,1990,29819752,1361911,44126601,31181663
Wisconsin,1991,29862554,1693543,44645118,31556097
Wisconsin,1992,30702384,1648447,45201710,32350831
Wisconsin,1993,31545797,1441361,45814297,32987158
Wisconsin,1994,32427483,1425733,46329888,33853216
Wisconsin,1995,33180733,1279739,46897480,34460472
Wisconsin,1996,33783342,1260799,47450070,35044141
Wisconsin,1997,34232152,1233909,47846658,35466061
Wisconsin,1998,34435669,1171359,48176250,35607028
Wisconsin,1999,34410621,1091539,48570841,35502160
Wisconsin,2000,34620724,1214711,49036470,35835435
Wisconsin,2001,34604803,1604525,49532652,36209328
Wisconsin,2002,34281204,1928399,50045352,36209603
Wisconsin,2003,34481033,2055133,50524628,36536166
Wisconsin,2004,34596650,1812142,50970558,36408792
Wisconsin,2005,34629305,1720842,51423127,36350147
Wisconsin,2006,35078521,1719284,51886383,36797805
Wisconsin,2007,35270985,1783083,52297927,37054068
Wisconsin,2008,35340748,1854551,52667868,37195299
Wisconsin,2009,34014758,3344736,53005604,37359494
Wisconsin,2010,33847558,3137172,53228476,36984730
Wisconsin,2011,34074943,2781585,53491008,36856528
Wisconsin,2012,34287768,2553115,53769939,36840883
Wisconsin,2013,34480393,2454384,54057134,36934777
Wisconsin,2014,34963430,1971797,54323336,36935227
Wisconsin,2015,35371792,1637863,54546618,37009655
Wisconsin,2016,35863450,1461862,54795781,37325312
Wisconsin,2017,36471642,1225639,55411457,37697281
Wisconsin,2018,36362834,1120658,55722282,37483492
Wisconsin,2019,36153301,1188301,56042286,37341602
Wisconsin,2020,34757979,2369297,56448291,37127276
Wisconsin,2021,35781234,1429014,56601243,37210248
Wisconsin,2022,35905761,1084387,56877525,36990148
Wyoming,1976,2083961,83549,3306000,2167510
Wyoming,1977,2264801,75868,3466000,2340669
Wyoming,1978,2452033,72064,3651000,2524097
Wyoming,1979,2610843,67956,3836000,2678799
Wyoming,1980,2717925,108264,4024000,2826189
Wyoming,1981,2844315,122824,4179000,2967139
Wyoming,1982,2857392,181167,4296000,3038559
Wyoming,1983,2836684,245716,4357000,3082400
Wyoming,1984,2865872,192824,4342000,3058696
Wyoming,1985,2833041,213698,4297000,3046739
Wyoming,1986,2757293,259938,4301000,3017231
Wyoming,1987,2681421,234384,4194000,2915805
Wyoming,1988,2683227,184927,4146000,2868154
Wyoming,1989,2688542,174144,4128000,2862686
Wyoming,1990,2700222,145417,3954256,2845639
Wyoming,1991,2700902,140974,4002769,2841876
Wyoming,1992,2714621,155362,4075860,2869983
Wyoming,1993,2765367,155668,4152956,2921035
Wyoming,1994,2850710,146715,4235046,2997425
Wyoming,1995,2892971,145231,4303141,3038202
Wyoming,1996,2908214,152906,4356232,3061120
Wyoming,1997,2927961,146267,4386328,3074228
Wyoming,1998,2974622,149180,4403418,3123802
Wyoming,1999,3016857,148861,4439513,3165718
Wyoming,2000,3069012,119683,4473819,3188695
Wyoming,2001,3097173,122345,4500510,3219518
Wyoming,2002,3103528,129905,4551763,3233433
Wyoming,2003,3131478,141529,4590974,3273007
Wyoming,2004,3169980,126279,4634445,3296259
Wyoming,2005,3230225,118697,4679342,3348922
Wyoming,2006,3315381,102851,4752433,3418232
Wyoming,2007,3397485,93591,4842646,3491076
Wyoming,2008,3453905,104719,4930315,3558624
Wyoming,2009,3374589,224942,5017396,3599531
Wyoming,2010,3371477,251361,5170766,3622838
Wyoming,2011,3411124,223200,5245581,3634324
Wyoming,2012,3445707,199931,5327135,3645638
Wyoming,2013,3454445,172068,5382652,3626513
Wyoming,2014,3476383,157998,5396394,3634381
Wyoming,2015,3467123,152998,5414822,3620121
Wyoming,2016,3413397,192176,5411899,3605573
Wyoming,2017,3373435,152660,5349548,3526095
Wyoming,2018,3368788,142349,5347936,3511137
Wyoming,2019,3389463,131040,5369277,3520503
Wyoming,2020,3316660,208169,5407522,3524829
Wyoming,2021,3309433,160410,5449763,3469843
Wyoming,2022,3375988,124665,5494738,3500653